R_fighter,B_fighter,BR_Total_time_fought,BR_total_rounds_fought,BR_total_title_bouts,BR_current_win_streak,BR_current_lose_streak,BR_longest_win_Streak,BR_Wins,BR_losses,BR_Height,BR_Reach,BR_Weight,BR_age,BR_Stance,Win
Song Kenan,Max Griffin,364.53125,18,0,-2,1,-1,0,5,-5,10,-15,4,0,0
Leon Edwards,Belal Muhammad,-397.519043,-4,0,0,0,-4,-1,1,-2,3,-5,3,-1,1
Matthew Semelsberger,Jason Witt,-661.5,0,0,-1,1,0,0,1,-1,2,-3,6,-2,2
Sean Brady,Jake Matthews,208.0285645,26,0,-1,0,0,7,4,3,1,2,-2,0,2
Belal Muhammad,Dhiego Lima,-91.82128906,-13,2,0,0,-1,-4,2,-6,8,-14,0,0,2
Kamaru Usman,Gilbert Burns,-468.9789429,-7,-4,-9,0,-6,0,3,-3,6,-9,1,-2,2
Warlley Alves,Mounir Lazzez,350.1298828,-24,-1,-3,0,-3,-6,-4,-2,-2,0,3,0,2
Michael Chiesa,Neil Magny,118.0332787,31,-1,-1,0,4,7,2,5,-3,8,0,-1,2
Carlos Condit,Matt Brown,-292.6670876,10,-3,1,-1,2,7,2,5,-3,8,4,0,2
David Zawada,Ramazan Emeev,378.25,8,0,3,-2,2,3,-1,4,-5,9,3,1,0
Santiago Ponzinibbio,Li Jingliang,18.31005859,7,0,1,-1,-3,0,2,-2,4,-6,-2,0,0
Stephen Thompson,Geoff Neal,-620.4558716,-34,-2,4,0,-2,-5,-5,0,-5,5,-7,1,2
Anthony Pettis,Alex Morono,-105.6681442,-22,-4,2,-1,-2,-3,-5,2,-7,9,-3,0,2
Michel Pereira,Khaos Williams,-734.125,-8,0,1,0,1,0,-2,2,-4,6,-1,0,2
Miguel Baeza,Takashi Sato,-87.75,2,0,-1,0,-1,0,1,-1,2,-3,2,1,2
Mike Perry,Tim Means,-30.31390476,18,0,0,0,2,5,4,1,3,-2,7,0,0
Daniel Rodriguez,Nicolas Dalby,107.75,10,0,-2,0,-2,-1,4,-5,9,-14,3,-1,0
Alex Morono,Rhys McKee,-175.578125,-22,0,-2,1,-3,-6,-3,-3,0,-3,-5,0,2
Abdul Razak Alhassan,Khaos Williams,-508.21875,-9,0,0,0,-2,-3,-2,-1,-1,0,-9,0,0
Cole Williams,Jason Witt,-107,0,0,0,0,0,0,0,0,0,0,-3,0,0
Claudio Silva,James Krause,412.8540039,18,0,-4,0,1,3,4,-1,5,-6,-4,-1,0
Carlos Condit,Court McGee,405.7943115,0,-2,3,-1,-2,1,-1,2,-3,5,-1,0,2
Diego Sanchez,Jake Matthews,58.76729391,-50,-2,-4,0,-3,-10,-8,-2,-6,4,-12,-1,0
Colby Covington,Tyron Woodley,-30.97021484,4,4,-2,0,-4,-1,3,-4,7,-11,6,0,2
Donald Cerrone,Niko Price,-69.70281932,-57,-1,-3,0,-6,-17,-7,-10,3,-13,-7,0,1
Bryan Barberena,Anthony Ivy,-658.8828125,-24,0,-1,1,-2,-5,-4,-1,-3,2,-1,-1,2
Michel Pereira,Zelim Imadaev,100.75,-2,0,-1,2,-1,-1,0,-1,1,-2,-1,0,2
Robbie Lawler,Neil Magny,-224.7132401,-5,-5,-2,0,2,3,-2,5,-7,12,-5,-1,0
Sean Brady,Christian Aguilera,-841,-5,0,-1,0,-1,-1,0,-1,1,-2,1,2,2
Daniel Rodriguez,Dwight Grant,41.25,2,0,-2,1,0,0,1,-1,2,-3,2,1,2
Tim Means,Laureano Staropoli,508.5975361,-36,0,0,0,-2,-9,-9,0,-9,9,-9,0,2
Vicente Luque,Randy Brown,-267.2022705,-5,0,1,-1,-4,-5,0,-5,5,-10,2,0,2
Alex Oliveira,Peter Sobotta,-124.8896027,-17,0,0,2,-1,-6,-2,-4,2,-6,1,1,2
Nicolas Dalby,Jesse Ronson,0,-6,0,-1,3,-1,-2,0,-2,2,-4,-1,1,1
Elizeu Zaleski dos Santos,Muslim Salikhov,-102.3964844,-17,0,0,0,-4,-5,-1,-4,3,-7,3,0,0
Kamaru Usman,Jorge Masvidal,-814.4612808,9,-3,-9,0,-8,1,6,-5,11,-16,2,-2,2
Mike Perry,Mickey Gall,216.3916016,-14,0,1,0,1,-1,-4,3,-7,10,0,2,2
Belal Muhammad,Lyman Good,-303.1503906,-18,0,1,-1,-3,-4,-1,-3,2,-5,4,0,2
Neil Magny,Anthony Rocco Martin,44.09613323,-17,0,-1,2,-3,-6,-1,-5,4,-9,-2,0,2
Tyron Woodley,Gilbert Burns,-742.1434326,-6,-6,2,0,2,2,-1,3,-4,7,-5,0,0
Matt Brown,Miguel Baeza,-33.81420124,-54,0,0,0,-6,-14,-10,-4,-6,2,-12,0,0
Anthony Pettis,Donald Cerrone,-287.1376811,27,-3,4,-1,3,14,2,12,-10,22,4,0,2
Vicente Luque,Niko Price,-547.2756348,-10,0,1,-1,-4,-4,1,-5,6,-11,2,0,2
Elizeu Zaleski dos Santos,Aleksei Kunchenko,298.7070313,-13,0,2,-1,-5,-5,-1,-4,3,-7,2,0,2
Demian Maia,Gilbert Burns,3.254568544,-55,-2,-2,0,-3,-12,-6,-6,0,-6,-9,-1,0
Neil Magny,Li Jingliang,85.10974693,-23,0,0,0,-3,-5,-3,-2,-1,-1,-1,0,2
Alex Oliveira,Max Griffin,111.4082947,-14,0,0,0,-2,-6,-2,-4,2,-6,2,0,2
Sean Brady,Ismail Naurdiev,0,6,0,0,0,0,1,1,0,1,-1,-4,0,2
Jake Matthews,Emil Meek,153.8857422,-19,0,-1,0,-2,-7,-2,-5,3,-8,6,2,2
Callan Potter,Song Kenan,273.5,5,0,2,-1,1,2,0,2,-2,4,-6,0,0
Diego Sanchez,Michel Pereira,-236.07967,-74,-2,-5,0,-5,-17,-11,-6,-5,-1,-12,-1,2
Rafael Dos Anjos,Michael Chiesa,-746.8582453,-56,-3,2,-2,-2,-9,-6,-3,-3,0,-3,0,0
Conor McGregor,Donald Cerrone,-361.7521993,47,-3,-3,0,1,14,8,6,2,4,5,-1,2
Geoff Neal,Mike Perry,290.6855469,18,0,-2,0,-2,2,5,-3,8,-11,-1,-1,2
Kamaru Usman,Colby Covington,-59.42773438,0,-1,-7,0,-3,0,1,-1,2,-3,-1,-2,2
Matt Brown,Ben Saunders,-52.55715919,-19,0,2,0,-4,-5,-1,-4,3,-7,-2,0,2
Thiago Alves,Tim Means,-500.0454061,-22,-1,2,-1,-3,-5,-2,-3,1,-4,-1,0,0
Sergio Moraes,James Krause,-168.2705078,-11,-1,1,-1,1,-1,-2,1,-3,4,-4,0,0
Warlley Alves,Randy Brown,-37.49804688,-4,-1,-3,0,-2,-2,0,-2,2,-4,1,0,0
Zelim Imadaev,Danny Roberts,-515.1953125,15,0,2,-1,2,5,3,2,1,1,8,1,0
Rustam Khabilov,Sergey Khandozhko,0.590332031,-30,0,-2,0,-5,-8,-3,-5,2,-7,-6,0,2
Ramazan Emeev,Anthony Rocco Martin,-43.70361328,26,0,-3,2,1,5,5,0,5,-5,-3,-1,0
Stephen Thompson,Vicente Luque,-294.9932861,-18,-2,-1,1,-1,1,-3,4,-7,11,-9,0,2
Jorge Masvidal,Nate Diaz,671.1030321,16,2,3,0,2,4,3,1,2,-1,0,1,2
Lyman Good,Chance Rencountre,432.125,0,0,-1,1,1,0,-1,1,-2,3,-2,1,2
Muslim Salikhov,Laureano Staropoli,503.5,1,0,2,-1,0,0,-1,1,-2,3,-9,0,2
Demian Maia,Ben Askren,-699.3741637,-80,-2,-4,0,-6,-20,-8,-12,4,-16,-6,-1,2
Niko Price,James Vick,37.87353516,12,0,4,0,3,4,0,4,-4,8,2,0,2
Max Griffin,Alex Morono,-379.9375,0,0,2,-1,1,2,-1,3,-4,7,-4,0,0
Jake Matthews,Rostem Akman,307.7714844,-22,0,-2,1,-3,-7,-3,-4,1,-5,2,2,2
Luke Jumeau,Dhiego Lima,-279.4296875,6,2,-1,1,1,1,4,-3,7,-10,-1,0,0
Nicolas Dalby,Alex Oliveira,-238.5665894,21,0,-1,1,2,8,3,5,-2,7,-3,0,2
Gunnar Nelson,Gilbert Burns,82.54638672,1,0,-1,0,-1,1,-1,2,-3,5,2,-2,0
Siyar Bahadurzada,Ismail Naurdiev,177.71875,-11,0,0,0,-2,-3,-2,-1,-1,0,-12,0,0
Belal Muhammad,Takashi Sato,-515.4257813,-23,0,1,-1,-3,-5,-3,-2,-1,-1,-2,1,2
Nordine Taleb,Muslim Salikhov,-133.9960938,-22,0,-3,1,-2,-6,-3,-3,0,-3,-3,0,0
Li Jingliang,Elizeu Zaleski dos Santos,-503.8417969,-7,0,-1,1,3,-1,-2,1,-3,4,1,0,2
Song Kenan,Derrick Krantz,-368,-5,0,-2,1,-2,-2,0,-2,2,-4,2,0,2
Anthony Pettis,Nate Diaz,494.9181309,17,-2,5,-1,0,5,2,3,-1,4,2,1,0
Vicente Luque,Mike Perry,309.5341797,4,0,2,-1,-3,-3,2,-5,7,-12,0,0,2
Gilbert Burns,Aleksei Kunchenko,315.2333984,-18,0,-1,0,-1,-6,-3,-3,0,-3,2,0,2
Colby Covington,Robbie Lawler,-499.8808346,30,4,0,0,-1,4,6,-2,8,-10,6,1,2
Mickey Gall,Salim Touahri,463.15625,-4,0,-3,2,-3,-4,0,-4,4,-8,2,-2,2
Geoff Neal,Niko Price,-325.265625,6,0,-2,0,-1,2,3,-1,4,-5,1,-1,2
Erik Koch,Kyle Stewart,-627.140625,-18,0,-2,1,-2,-4,-4,0,-4,4,0,-1,2
Rafael Dos Anjos,Leon Edwards,-208.4909047,-45,-4,0,-1,2,-9,-7,-2,-5,3,-7,0,0
Jorge Masvidal,Ben Askren,-439.3697205,-42,0,-1,0,-2,-9,-6,-3,-3,0,0,0,2
Diego Sanchez,Michael Chiesa,-217.2403947,-51,-1,-4,0,-3,-10,-7,-3,-4,1,-6,0,0
Ismail Naurdiev,Chance Rencountre,-377.5,1,0,-1,1,0,0,1,-1,2,-3,10,1,0
Demian Maia,Anthony Rocco Martin,108.8444461,-47,-2,-5,2,-3,-12,-5,-7,2,-9,-12,-1,2
Bryan Barberena,Randy Brown,-75.28125,-4,0,0,0,0,-1,-1,0,-1,1,-2,-1,0
Rafael Dos Anjos,Kevin Lee,-146.020872,-38,-3,0,-1,0,-7,-5,-2,-3,1,-8,-1,2
Thiago Alves,Laureano Staropoli,52.68947649,-58,-1,1,-1,-6,-14,-10,-4,-6,2,-9,0,0
Warlley Alves,Sergio Moraes,190.8925781,9,0,-4,1,0,2,1,1,0,1,8,0,2
Alex Oliveira,Mike Perry,133.3753662,-10,0,2,-1,-1,-4,-1,-3,2,-5,-4,0,0
Court McGee,Dhiego Lima,-538.630127,-27,1,-3,1,-2,-6,-1,-5,4,-9,-4,0,0
Sultan Aliev,Keita Nakamura,323.8203125,23,0,0,2,0,3,4,-1,5,-6,0,1,2
Alan Jouban,Dwight Grant,208.4755859,-17,0,-1,1,-2,-6,-3,-3,0,-3,-3,1,0
Curtis Millender,Belal Muhammad,402.2265625,13,0,-3,1,1,2,2,0,2,-2,-1,0,0
Stephen Thompson,Anthony Pettis,-725.2581787,0,2,-1,1,-2,-1,3,-4,7,-11,-4,0,0
Danny Roberts,Claudio Silva,17.28125,-7,0,1,0,1,-2,-2,0,-2,2,5,0,0
Darren Till,Jorge Masvidal,2.098815918,22,-1,1,0,-1,4,4,0,4,-4,8,-1,0
Leon Edwards,Gunnar Nelson,-774.6152344,-7,0,4,-1,-2,0,1,-1,2,-3,3,1,2
Elizeu Zaleski dos Santos,Curtis Millender,346.078125,-10,0,3,-1,-3,-3,-1,-2,1,-3,-1,0,2
Anthony Rocco Martin,Sergio Moraes,-78.43945313,-1,1,0,-1,1,1,-1,2,-3,5,7,0,2
Tim Means,Niko Price,-222.2509613,-30,0,-1,0,-2,-6,-5,-1,-4,3,-6,0,0
Alex Morono,Zak Ottow,-134.8125,-2,0,-1,0,-1,0,0,0,0,0,4,0,2
Tyron Woodley,Kamaru Usman,342.7363281,-4,-4,8,0,6,0,-3,3,-6,9,-5,2,0
Diego Sanchez,Mickey Gall,-284.6311799,-65,-2,-3,0,-3,-13,-10,-3,-7,4,-10,1,2
Dwight Grant,Carlo Pedersoli Jr.,-430.5,1,0,1,-1,1,1,0,1,-1,2,-9,-1,2
Vicente Luque,Bryan Barberena,113.1835938,4,0,1,-1,-2,-2,1,-3,4,-7,2,1,2
Demian Maia,Lyman Good,-849.2466548,-72,-2,-4,0,-6,-17,-8,-9,1,-10,-8,-1,2
Thiago Alves,Max Griffin,42.37895298,-45,-1,0,0,-6,-12,-7,-5,-2,-3,-2,0,2
Belal Muhammad,Geoff Neal,-598.203125,-16,0,2,-1,-2,-3,-2,-1,-1,0,-2,1,0
Carlos Condit,Michael Chiesa,-254.4588623,-21,-2,2,-1,-2,0,-4,4,-8,12,-3,1,0
Curtis Millender,Siyar Bahadurzada,-183.9375,9,0,-1,0,1,2,2,0,2,-2,3,0,2
Alex Oliveira,Gunnar Nelson,-6.385986328,-7,0,4,-1,1,-2,-1,-1,0,-1,0,2,0
Chad Laprise,Dhiego Lima,258.171875,-8,1,-3,1,-2,-5,2,-7,9,-16,-3,0,0
Yushin Okami,Aleksei Kunchenko,299.6282845,-49,-1,-3,0,-3,-13,-6,-7,1,-8,-3,-1,0
Jake Matthews,Anthony Rocco Martin,265.9140625,4,0,-2,2,0,-1,1,-2,3,-5,4,0,0
Keita Nakamura,Salim Touahri,21.359375,-23,0,0,-2,-1,-3,-5,2,-7,9,-5,-1,2
Rafael Dos Anjos,Kamaru Usman,-164.1120564,-46,-3,8,-2,3,-9,-8,-1,-7,6,-3,1,0
Tim Means,Ricky Rainey,-284.4394226,-38,0,-2,1,-4,-9,-7,-2,-5,3,1,2,2
Song Kenan,Alex Morono,389.25,12,0,0,0,0,1,3,-2,5,-7,0,0,0
Li Jingliang,David Zawada,116.1445313,-20,0,-1,1,-4,-7,-2,-5,3,-8,-2,0,2
Michel Prazeres,Bartosz Fabinski,76.625,-22,0,3,-1,-4,-6,-2,-4,2,-6,-5,0,2
Neil Magny,Santiago Ponzinibbio,180.3855095,-27,0,-1,1,-1,-6,-3,-3,0,-3,1,0,0
Donald Cerrone,Mike Perry,-115.2264973,-41,-1,-2,0,-6,-15,-5,-10,5,-15,-8,0,2
Lyman Good,Ben Saunders,-260.2150269,27,0,2,0,2,8,6,2,4,-2,2,0,2
Nordine Taleb,Sean Strickland,202.4726563,2,0,-1,0,0,0,0,0,0,0,-10,0,0
Alex Garcia,Court McGee,106.3579102,14,1,1,0,1,2,2,0,2,-2,2,0,0
Ryan LaFlare,Anthony Rocco Martin,86.4921875,-5,0,-4,2,-1,-2,2,-4,6,-10,-7,-1,0
Alex Oliveira,Carlo Pedersoli Jr.,361.5327148,-24,0,1,-1,-2,-7,-4,-3,-1,-2,-5,1,2
Sergio Moraes,Ben Saunders,-396.9222412,4,-1,3,-1,-1,2,3,-1,4,-5,-1,0,2
Abdul Razak Alhassan,Niko Price,129.0625,4,0,0,0,0,1,1,0,1,-1,-5,0,2
Geoff Neal,Frank Camacho,732,8,0,-1,1,0,0,2,-2,4,-6,1,-1,2
Tyron Woodley,Darren Till,-335.6757813,-13,-4,0,0,1,-3,-2,-1,-1,0,-11,1,2
Diego Sanchez,Craig White,-38.63735987,-69,-2,-6,1,-6,-16,-10,-6,-4,-2,-8,-1,2
James Krause,Warlley Alves,-124.8710938,-1,1,3,0,0,0,-1,1,-2,3,-5,0,2
Jake Ellenberger,Bryan Barberena,485.9006348,-22,0,1,-1,-4,-6,-7,1,-8,9,-4,1,0
Mickey Gall,George Sullivan,-26.09375,7,0,-1,0,-1,0,2,-2,4,-6,11,-2,2
Jordan Mein,Alex Morono,-351.515625,-6,0,1,0,0,-1,-2,1,-3,4,-1,0,2
Emil Meek,Bartosz Fabinski,0,0,0,1,0,1,1,-1,2,-3,5,3,-2,0
Randy Brown,Niko Price,-319.09375,-8,0,0,0,-1,-1,0,-1,1,-2,0,0,0
Sage Northcutt,Zak Ottow,-456.40625,-5,0,-1,0,-1,-2,0,-2,2,-4,9,0,2
Paul Felder,Mike Perry,284.3261719,-8,0,0,0,-1,-3,0,-3,3,-6,-8,0,0
Curtis Millender,Max Griffin,217,8,0,-1,1,0,1,2,-1,3,-4,2,0,2
Li Jingliang,Daichi Abe,232.2890625,-14,0,0,0,-3,-5,-2,-3,1,-4,-4,0,2
Donald Cerrone,Leon Edwards,505.1563803,-30,-1,-4,1,-3,-13,-5,-8,3,-11,-9,1,0
Shinsho Anzai,Jake Matthews,170.9140625,14,0,2,-1,0,4,2,2,0,2,-9,0,0
Rafael Dos Anjos,Colby Covington,-170.3647379,-41,-3,3,-2,0,-9,-6,-3,-3,0,-3,-1,0
CM Punk,Mike Jackson,-89,0,0,0,0,0,0,0,0,0,0,-6,0,1
Jake Ellenberger,Ben Saunders,174.8161621,-10,0,3,-1,-3,-2,-3,1,-4,5,2,0,0
Stephen Thompson,Darren Till,-578.5844727,-21,-2,0,0,-4,-5,-2,-3,1,-4,-10,1,0
Claudio Silva,Nordine Taleb,-463.03125,14,0,1,0,1,4,2,2,0,2,1,-1,2
Zak Cummings,Michel Prazeres,292.4140625,12,0,-2,1,4,2,0,2,-2,4,3,-1,0
Demian Maia,Kamaru Usman,-290.1339345,-55,-1,2,0,0,-12,-8,-4,-4,0,-9,1,0
Vicente Luque,Chad Laprise,-147.171875,5,1,3,-1,-1,1,0,1,-1,2,5,0,2
Elizeu Zaleski dos Santos,Sean Strickland,0.2265625,7,0,2,-1,-1,2,1,1,0,1,-4,0,2
Alberto Mina,Ramazan Emeev,422.25,-3,0,-2,0,-2,-2,0,-2,2,-4,-6,1,0
Warlley Alves,Sultan Aliev,-302.921875,-14,-1,-4,1,-3,-4,-1,-3,2,-5,6,0,2
Ryan LaFlare,Alex Garcia,-86.1328125,-6,0,-2,0,-2,-1,1,-2,3,-5,-4,-1,2
Siyar Bahadurzada,Luan Chagas,99.125,-4,0,-1,2,-1,-2,0,-2,2,-4,-10,0,2
Anthony Rocco Martin,Keita Nakamura,-8.203125,3,0,0,1,-2,-1,1,-2,3,-5,5,1,2
Carlos Condit,Alex Oliveira,-167.6589355,-16,-3,0,0,-2,0,-3,3,-6,9,-3,0,0
Dhiego Lima,Yushin Okami,30.18093109,41,-1,4,-1,3,12,2,10,-8,18,7,1,0
Danny Roberts,Oliver Enkamp,559.125,-7,0,-2,1,-2,-3,-1,-2,1,-3,-4,1,2
Leon Edwards,Peter Sobotta,-346.21875,-3,0,0,2,-2,-2,2,-4,6,-10,5,0,2
Mike Pyle,Zak Ottow,152.8963852,-26,0,1,-1,-3,-8,-6,-2,-4,2,-11,0,0
Mike Perry,Max Griffin,42.0625,-6,0,-2,1,-1,-3,0,-3,3,-6,6,0,0
Ben Saunders,Alan Jouban,-244.230957,-8,0,-2,0,0,-2,-1,-1,0,-1,2,1,0
Donald Cerrone,Yancy Medeiros,132.3547528,-34,-1,-4,3,-5,-13,-2,-11,9,-20,-4,0,2
Joshua Burkman,Alex Morono,487.4727631,-33,0,0,0,0,-4,-10,6,-16,22,-10,0,0
Jake Matthews,Li Jingliang,-358.40625,-1,0,-1,0,2,1,-1,2,-3,5,6,0,2
Luke Jumeau,Daichi Abe,0,-3,0,0,0,0,0,-1,1,-2,3,-3,0,2
Sergio Moraes,Tim Means,249.8944702,14,-1,2,-1,0,3,4,-1,5,-6,-2,0,2
Drew Dober,Frank Camacho,602.515625,-11,0,0,-1,-1,-3,-4,1,-5,6,-1,-1,2
Niko Price,George Sullivan,122.8125,6,0,1,0,1,1,0,1,-1,2,8,0,2
Sabah Homasi,Abdul Razak Alhassan,0.25,2,0,1,-2,1,2,-1,3,-4,7,3,0,0
Kamaru Usman,Emil Meek,382.28125,-12,-1,-5,0,-5,-5,0,-5,5,-10,-1,0,2
Carlos Condit,Neil Magny,-118.3540497,6,-3,1,-1,2,5,-1,6,-7,13,-3,0,0
Chad Laprise,Galore Bofando,-416.4375,-16,-1,-2,0,-2,-4,-2,-2,0,-2,4,2,2
Robbie Lawler,Rafael Dos Anjos,-259.7471859,7,-2,-3,2,0,3,2,1,1,0,-2,0,0
Nordine Taleb,Danny Roberts,-192.1875,-10,0,-1,0,-1,-2,-1,-1,0,-1,-6,1,2
Santiago Ponzinibbio,Mike Perry,-109.3125,-8,0,2,-1,-3,-3,-1,-2,1,-3,-5,0,2
Jordan Mein,Erick Silva,-218.0157471,10,0,0,0,0,4,3,1,2,-1,5,0,2
Alex Oliveira,Yancy Medeiros,42.52734375,-5,0,0,2,-1,-2,2,-4,6,-10,1,0,0
Sabah Homasi,Abdul Razak Alhassan,0.5,2,0,1,-1,1,1,0,1,-1,2,3,0,0
Li Jingliang,Zak Ottow,206.15625,-7,0,0,0,-2,-3,-1,-2,1,-3,1,0,2
Jake Matthews,Bojan Velickovic,206.59375,0,0,-1,0,-1,-2,0,-2,2,-4,5,1,2
Tim Means,Belal Muhammad,149.0548096,-21,0,-2,1,-2,-6,-4,-2,-2,0,-4,0,0
Matt Brown,Diego Sanchez,-131.9820852,16,2,5,0,-1,3,0,3,-3,6,-1,1,2
Court McGee,Sean Strickland,66.74511719,-14,-1,-1,0,0,-2,-3,1,-4,5,-6,0,0
Stephen Thompson,Jorge Masvidal,-666.8150635,8,-2,1,0,-4,1,2,-1,3,-4,-2,0,2
Randy Brown,Mickey Gall,-463.1875,-9,0,2,0,1,0,-2,2,-4,6,-2,2,2
Vicente Luque,Niko Price,-273.28125,-7,0,1,-1,-3,-2,-1,-1,0,-1,3,0,2
Demian Maia,Colby Covington,-264.5491191,-50,-2,-2,0,-3,-12,-6,-6,0,-6,-10,-1,0
Elizeu Zaleski dos Santos,Max Griffin,-489.375,-8,0,0,0,-2,-2,0,-2,2,-4,1,0,2
Donald Cerrone,Darren Till,159.4380213,-42,-1,-3,0,-6,-16,-5,-11,6,-17,-10,1,0
Keita Nakamura,Alex Morono,-64.5625,-12,0,2,-3,1,0,-4,4,-8,12,-6,-1,2
Shinsho Anzai,Luke Jumeau,448,-1,0,1,-1,0,0,-1,1,-2,3,-2,0,2
Kamaru Usman,Sergio Moraes,10.53125,8,0,-5,1,-1,1,2,-1,3,-4,5,-2,2
Neil Magny,Rafael Dos Anjos,194.6680274,15,3,-1,2,-2,3,3,0,3,-3,2,1,0
Darren Till,Bojan Velickovic,114.25,4,0,0,0,0,0,1,-1,2,-3,4,0,2
Leon Edwards,Bryan Barberena,-330.1875,-4,0,1,-1,-1,-1,0,-1,1,-2,2,0,2
Alan Jouban,Niko Price,-109.0976563,-15,0,0,0,-2,-5,-2,-3,1,-4,-8,-1,0
Tyron Woodley,Demian Maia,-523.9408243,40,-2,4,0,4,12,3,9,-6,15,4,1,2
Robbie Lawler,Donald Cerrone,-312.454366,1,-4,1,0,3,7,0,7,-7,14,-1,-1,2
Lyman Good,Elizeu Zaleski dos Santos,353.75,7,0,-1,1,1,1,1,0,1,-1,-2,0,0
Ryan LaFlare,Alex Oliveira,-509.2617188,-3,0,-4,1,-1,0,2,-2,4,-6,-4,-1,0
Danny Roberts,Bobby Nash,-121.5,-5,0,-2,1,-2,-2,0,-2,2,-4,-3,-1,2
Gunnar Nelson,Santiago Ponzinibbio,277.6796875,-3,0,-4,1,0,-1,0,-1,1,-2,2,-2,0
Chad Laprise,Brian Camozzi,-20.875,-12,-1,-3,1,-3,-4,-1,-3,2,-5,-4,0,2
Jordan Mein,Belal Muhammad,69.5625,-2,0,-1,1,-1,-1,-1,0,-1,1,1,0,0
Dhiego Lima,Jesse Taylor,39.875,-5,-1,0,0,-1,-1,-2,1,-3,4,6,0,0
Tim Means,Alex Garcia,129.9533691,-17,0,0,0,-2,-4,-4,0,-4,4,-4,0,2
Dong Hyun Kim,Colby Covington,133.4446259,-25,0,1,0,-1,-7,-3,-4,1,-5,-6,-1,0
Tarec Saffiedine,Rafael Dos Anjos,26.41790295,38,3,-1,2,4,12,4,8,-4,12,2,-1,0
Kiichi Kunimoto,Zak Ottow,290.375,-2,0,-2,0,-2,-2,0,-2,2,-4,-6,0,0
Erick Silva,Yancy Medeiros,-123.2380371,-8,0,-1,3,0,-3,-1,-2,1,-3,-3,0,0
Luan Chagas,Jim Wallhead,31.5,-3,0,0,-1,0,0,-1,1,-2,3,10,0,2
Abdul Razak Alhassan,Omari Akhmedov,739.484375,14,0,0,0,1,3,3,0,3,-3,-2,0,0
Nicholas Musoke,Bojan Velickovic,44.5625,-4,0,-1,0,-1,-2,0,-2,2,-4,-3,1,0
Darren Till,Jessin Ayari,251.5,-2,0,0,0,0,0,-1,1,-2,3,0,-1,2
Peter Sobotta,Ben Saunders,72.68457031,8,0,3,-3,1,5,0,5,-5,10,4,-1,2
Demian Maia,Jorge Masvidal,-16.98871267,-27,-1,-3,0,-3,-9,-2,-7,5,-12,-7,-1,2
Jake Ellenberger,Mike Perry,412.8525391,-30,0,2,-1,-4,-8,-7,-1,-6,5,-7,0,0
Bryan Barberena,Joe Proctor,-450.390625,0,0,0,0,0,1,1,0,1,-1,4,-1,2
Zak Cummings,Nathan Coy,-114.671875,-11,0,-2,1,-1,-4,-1,-3,2,-5,6,0,2
Kamaru Usman,Sean Strickland,36.78125,5,-1,-2,0,-1,1,1,0,1,-1,-3,-2,2
Thiago Alves,Patrick Cote,-77.22809792,0,1,0,3,-3,-3,2,-5,7,-12,4,0,2
Leon Edwards,Vicente Luque,-627.0625,-8,0,0,0,2,0,-1,1,-2,3,0,-1,2
Gunnar Nelson,Alan Jouban,122.8046875,-2,0,-3,0,-1,0,0,0,0,0,7,-1,2
Alex Oliveira,Tim Means,-148.4458008,11,0,2,-1,1,3,2,1,1,0,4,0,2
Tyron Woodley,Stephen Thompson,268.7597656,5,-1,0,0,4,2,-1,3,-4,7,0,0,2
Nordine Taleb,Santiago Ponzinibbio,61,1,0,-3,1,0,1,1,0,1,-1,-5,0,0
Randy Brown,Belal Muhammad,-36.625,-3,0,-1,1,-1,-2,1,-3,4,-7,2,0,0
Ryan LaFlare,Roan Carneiro,-457.2734375,-3,0,-3,0,-3,-1,3,-4,7,-11,5,-1,2
Alex Morono,Niko Price,-630,-5,0,-1,0,-1,-1,0,-1,1,-2,1,0,1
Donald Cerrone,Jorge Masvidal,39.16761255,-15,-1,-2,0,-5,-11,0,-11,11,-22,-1,0,0
Court McGee,Ben Saunders,-263.046875,-8,-1,0,0,0,0,0,0,0,0,1,0,0
Dong Hyun Kim,Tarec Saffiedine,581.6392517,-25,0,-1,0,-3,-10,-2,-8,6,-14,-5,1,2
Johny Hendricks,Neil Magny,-227.5960236,-6,-3,-3,0,1,-1,-1,0,-1,1,-4,-1,0
Mike Pyle,Alex Garcia,271.7302704,-22,0,2,-1,-2,-7,-5,-2,-3,1,-12,0,0
Alex Oliveira,Tim Means,-296.8916016,11,0,2,-1,1,3,2,1,1,0,4,0,1
Alan Jouban,Mike Perry,-35.390625,-9,0,1,0,0,-3,-2,-1,-1,0,-10,-1,2
James Moontasri,Alex Morono,277.1875,-7,0,1,-1,0,-1,-3,2,-5,7,-2,-2,0
Bryan Barberena,Colby Covington,-150.75,3,0,2,0,1,2,0,2,-2,4,1,-1,0
Sage Northcutt,Mickey Gall,-531.75,-6,0,0,0,0,-1,-1,0,-1,1,4,2,0
Bojan Velickovic,Sultan Aliev,-738,-5,0,-1,1,-1,-1,0,-1,1,-2,5,-1,0
Donald Cerrone,Matt Brown,-42.9822197,5,-1,-3,0,-1,-5,5,-10,15,-25,2,0,2
Jake Ellenberger,Jorge Masvidal,556.5361328,-4,0,2,-1,-3,-3,-3,0,-3,3,1,0,0
Kyle Noke,Omari Akhmedov,51.18847656,-10,0,-2,0,-1,-3,-2,-1,-1,0,-7,-1,0
Richard Walsh,Jonathan Meunier,-150.875,-10,0,-1,1,-1,-2,-2,0,-2,2,2,2,0
Sergio Moraes,Zak Ottow,88.125,-13,-1,1,-1,-3,-3,-2,-1,-1,0,-5,0,2
Warlley Alves,Kamaru Usman,134.0625,-4,0,-1,0,-1,-1,-1,0,-1,1,4,2,0
Zak Cummings,Alexander Yakovlev,-18.59375,0,0,-2,2,0,-2,1,-3,4,-7,0,0,2
Tyron Woodley,Stephen Thompson,537.5195313,5,-1,0,0,4,2,-1,3,-4,7,-1,0,1
Vicente Luque,Belal Muhammad,587.375,-1,0,0,0,-2,-2,0,-2,2,-4,4,0,2
Erick Montano,Max Griffin,-21,-3,-1,-1,1,-1,-1,0,-1,1,-2,0,0,0
Leon Edwards,Albert Tumenov,-273.90625,1,0,0,0,3,2,0,2,-2,4,-1,-1,2
Danny Roberts,Mike Perry,-315,-3,0,-1,0,-1,-1,0,-1,1,-2,-4,-1,0
Keita Nakamura,Elizeu Zaleski dos Santos,112.375,-11,0,0,-2,0,-1,-3,2,-5,7,-3,-1,0
Erick Silva,Luan Chagas,410.9379883,-17,0,-1,1,-2,-6,-5,-1,-4,3,-9,0,2
Vicente Luque,Hector Urbina,34.75,-2,0,1,-1,-1,-1,0,-1,1,-2,5,0,2
Roan Carneiro,Kenny Robertson,364.6015625,3,0,-1,2,2,1,0,1,-1,2,-6,0,2
Augusto Montano,Belal Muhammad,305,-1,0,-1,1,-1,-1,0,-1,1,-2,-3,0,0
Erick Montano,Randy Brown,-224.5,2,-1,0,0,0,0,1,-1,2,-3,-4,0,0
Yancy Medeiros,Sean Spencer,149.3046875,8,0,0,-2,0,0,-1,1,-2,3,0,0,2
Peter Sobotta,Nicolas Dalby,570.25,-5,0,1,-3,-1,-1,-2,1,-3,4,2,-1,2
Demian Maia,Carlos Condit,206.4810708,-24,2,-5,1,0,-10,-1,-9,8,-17,-6,-1,2
Rick Story,Donald Cerrone,-469.9566212,-6,1,4,-1,2,5,-2,7,-9,16,2,-1,0
Nate Diaz,Conor McGregor,-278.7062569,-39,0,2,0,2,-7,-7,0,-7,7,-3,0,0
Neil Magny,Lorenz Larkin,-84.49182129,-17,0,-1,1,-5,-7,2,-9,11,-20,0,0,0
Court McGee,Dominique Steele,41.16796875,-20,-1,-3,1,-2,-5,-2,-3,1,-4,-3,0,2
Santiago Ponzinibbio,Zak Cummings,265.1875,-1,0,2,-1,0,0,-1,1,-2,3,3,1,2
Matt Brown,Jake Ellenberger,-92.43737602,-14,0,-1,1,-1,-4,-1,-3,2,-5,-4,0,0
Ross Pearson,Jorge Masvidal,84.52828598,-22,-1,-1,0,0,-5,-5,0,-5,5,0,0,0
Robbie Lawler,Tyron Woodley,-776.3441467,-34,-4,-2,0,-3,-7,-2,-5,3,-8,0,-1,0
Michael Graves,Bojan Velickovic,224.5,-2,0,-1,0,-1,-1,0,-1,1,-2,2,1,1
Kamaru Usman,Alexander Yakovlev,-70,5,-1,-2,2,0,0,2,-2,4,-6,3,-1,2
Alex Oliveira,James Moontasri,-70.1875,-4,0,0,0,-2,-1,0,-1,1,-2,0,2,2
Kyle Noke,Keita Nakamura,190.6894531,-5,0,-3,3,-2,-5,0,-5,5,-10,-4,0,0
Johny Hendricks,Kelvin Gastelum,402.8786316,-22,-2,1,0,-1,-6,-2,-4,2,-6,-8,0,0
Li Jingliang,Anton Zafir,-338.75,-9,0,-1,1,-1,-2,-1,-1,0,-1,1,0,2
Mike Pyle,Alberto Mina,-158.9144592,-29,0,2,-1,-2,-8,-6,-2,-4,2,-6,0,0
Vicente Luque,Alvaro Herrera Mendoza,-486.5,-3,0,1,-1,0,0,-1,1,-2,3,2,0,2
Rory MacDonald,Stephen Thompson,-689.2382813,-18,-1,0,0,1,-2,-2,0,-2,2,7,0,0
Donald Cerrone,Patrick Cote,305.4972382,7,1,-4,4,-4,-6,5,-11,16,-27,3,0,2
Sean Strickland,Tom Breese,-249.5625,-8,0,1,0,1,-1,-1,0,-1,1,-1,1,2
Jorge Masvidal,Lorenz Larkin,-358.9804688,-7,0,-2,1,-1,-3,2,-5,7,-12,-2,0,0
Tarec Saffiedine,Rick Story,68.89656067,35,0,-1,1,5,9,5,4,1,3,2,-1,0
Demian Maia,Matt Brown,-257.7314658,-12,-1,-4,0,2,-3,1,-4,5,-9,-3,-1,2
Warlley Alves,Bryan Barberena,297.625,-1,-1,-3,0,-3,-2,1,-3,4,-7,2,1,0
Albert Tumenov,Gunnar Nelson,98.09375,4,0,4,-1,-1,0,1,-1,2,-3,3,2,0
Leon Edwards,Dominic Waters,-243,-6,0,0,1,-2,-2,0,-2,2,-4,3,-1,2
Danny Roberts,Dominique Steele,169,3,0,-1,1,0,0,1,-1,2,-3,0,-1,2
Court McGee,Santiago Ponzinibbio,-469.6640625,-16,-1,-3,1,-1,-3,-1,-2,1,-3,-2,0,0
Randy Brown,Michael Graves,0,0,0,0,0,0,0,0,0,0,0,0,0,0
Elizeu Zaleski dos Santos,Omari Akhmedov,-313.0625,6,0,1,-1,2,3,1,2,-1,3,-1,0,2
Nicolas Dalby,Zak Cummings,-586.625,1,0,1,0,1,2,0,2,-2,4,0,1,0
Hector Lombard,Neil Magny,323.6398926,22,0,1,-1,5,7,0,7,-7,14,-10,-1,0
Brendan O'Reilly,Alan Jouban,-497.4375,3,0,1,-1,1,2,1,1,0,1,6,1,0
Richard Walsh,Viscardi Andrade,-10.75,-3,0,0,0,0,0,-1,1,-2,3,5,0,0
Brandon Thatch,Siyar Bahadurzada,287.375,0,0,-1,0,-1,-1,0,-1,1,-2,1,-2,0
Conor McGregor,Nate Diaz,557.4125137,39,0,-2,0,-2,6,8,-2,10,-12,3,0,0
Erick Silva,Nordine Taleb,141.3759766,-7,0,2,0,1,-3,-4,1,-5,6,3,0,0
Tom Breese,Keita Nakamura,531,10,0,-2,3,-1,-1,3,-4,7,-11,7,0,2
Donald Cerrone,Alex Oliveira,289.6583633,-29,-1,-4,1,-5,-12,-3,-9,6,-15,-4,0,2
Alex Garcia,Sean Strickland,28.75,0,0,0,0,0,0,0,0,0,0,-4,0,0
Jonavin Webb,Nathan Coy,-734,-2,0,0,0,0,0,0,0,0,0,11,1,0
Johny Hendricks,Stephen Thompson,-687.0083618,-28,-3,-3,0,-1,-6,-2,-4,2,-6,0,-1,0
Mike Pyle,Sean Spencer,284.9523315,-12,0,0,0,-2,-6,-3,-3,0,-3,-12,0,2
Sage Northcutt,Bryan Barberena,653,3,0,-1,0,-1,-1,1,-2,3,-5,7,1,0
Tarec Saffiedine,Jake Ellenberger,-692.8203125,24,0,-1,1,5,8,5,3,2,1,1,-2,2
George Sullivan,Alexander Yakovlev,75.875,-2,0,-2,2,-1,-2,1,-3,4,-7,-3,1,0
Patrick Cote,Ben Saunders,-202.7228317,-25,-2,3,-4,-1,-2,-6,4,-10,14,-3,0,2
Lorenz Larkin,Albert Tumenov,-69.3125,-7,0,0,0,2,1,-3,4,-7,11,-5,0,0
Robbie Lawler,Carlos Condit,-650.5652466,-11,-1,-3,1,1,-4,0,-4,4,-8,-2,-1,2
Sheldon Westcott,Edgar Garcia,-345.75,0,-1,0,1,0,0,1,-1,2,-3,0,-1,2
Kamaru Usman,Leon Edwards,298,5,-1,-1,1,1,1,1,0,1,-1,-4,-1,2
Hayder Hassan,Vicente Luque,521,1,-1,0,0,0,0,0,0,0,0,-9,-3,0
Warlley Alves,Colby Covington,67.25,-1,-1,0,0,0,0,0,0,0,0,3,0,2
Demian Maia,Gunnar Nelson,-258.0093107,-42,-1,-1,0,-1,-10,-5,-5,0,-5,-11,1,2
Court McGee,Marcio Alexandre Junior,-132.828125,-17,0,-3,2,-3,-5,-1,-4,3,-7,-4,1,2
Ryan LaFlare,Mike Pierce,-877.6591797,17,0,-3,0,0,5,3,2,1,1,3,-1,2
Omari Akhmedov,Sergio Moraes,273.625,4,1,-1,1,1,0,0,0,0,0,5,0,0
Tim Means,John Howard,232.9301758,11,0,2,0,0,1,2,-1,3,-4,1,0,2
Santiago Ponzinibbio,Andreas Stahl,309,-6,0,0,0,-2,-2,-1,-1,0,-1,-2,0,2
Dong Hyun Kim,Dominic Waters,357.2785034,-35,0,-2,1,-4,-11,-3,-8,5,-13,-8,-1,2
Yoshihiro Akiyama,Alberto Mina,-543.875,-15,0,0,0,0,-1,-4,3,-7,10,-7,0,0
Benson Henderson,Jorge Masvidal,-369.34375,-26,-5,-5,0,-4,-4,-1,-3,2,-5,-1,-1,2
Neil Magny,Kelvin Gastelum,-45.18603516,-15,1,4,0,-2,-3,-2,-1,-1,0,-4,1,2
Hector Urbina,Bartosz Fabinski,682,2,0,0,0,0,0,0,0,0,0,1,0,0
Kyle Noke,Peter Sobotta,-214.7421875,-3,0,-3,3,-1,-3,0,-3,3,-6,-7,0,2
Richard Walsh,Steve Kennedy,-342.5,-6,0,-1,1,-1,-1,-1,0,-1,1,6,0,2
Viscardi Andrade,Gasan Umalatov,402,5,0,-1,1,0,0,1,-1,2,-3,2,0,2
Nicolas Dalby,Darren Till,-503,-1,0,0,0,0,0,0,0,0,0,-8,1,1
Cathal Pendred,Tom Breese,-577.8125,-13,0,-3,0,-3,-3,-1,-2,1,-3,-4,1,0
Alan Jouban,Albert Tumenov,-22.375,0,0,-1,1,1,0,0,0,0,0,-10,-1,0
Keita Nakamura,Li Jingliang,-407.5,-2,0,1,-3,1,2,-2,4,-6,10,-4,-1,2
Neil Magny,Erick Silva,-245.0615234,-13,0,0,0,-5,-2,1,-3,4,-7,3,0,2
Patrick Cote,Joshua Burkman,-76.17906189,-12,-2,2,-4,-2,-3,-2,-1,-1,0,0,0,2
Demian Maia,Neil Magny,-664.5244808,-27,-1,-4,0,2,-6,-4,-2,-2,0,-10,-1,2
Warlley Alves,Nordine Taleb,137.5,3,-1,1,0,1,1,0,1,-1,2,10,0,2
Kenny Robertson,Ben Saunders,-147.6328125,3,0,3,-2,0,2,0,2,-2,4,1,0,0
Leon Edwards,Pawel Pawlak,446,2,0,0,0,0,0,0,0,0,0,3,-1,2
Alan Jouban,Matt Dwyer,-231.75,-3,0,-1,1,0,-1,0,-1,1,-2,-8,-1,2
Igor Araujo,Sean Strickland,67.75,-1,0,0,0,0,0,0,0,0,0,-10,0,0
Jorge Masvidal,Cezar Ferreira,-472.578125,-8,1,1,0,0,-1,0,-1,1,-2,0,1,2
Jake Ellenberger,Stephen Thompson,113.046875,-18,0,1,-1,-2,-4,-4,0,-4,4,2,0,0
Matt Brown,Tim Means,-279.6166916,-22,0,1,0,-3,-6,-4,-2,-2,0,-3,0,2
Gunnar Nelson,Brandon Thatch,-378.875,-6,0,-2,0,-2,-2,0,-2,2,-4,3,0,2
Robbie Lawler,Rory MacDonald,-567.4468994,-10,-2,-2,0,2,-1,-2,1,-3,4,-8,-1,2
Cathal Pendred,John Howard,-335.2724609,21,0,0,0,0,2,6,-4,10,-14,5,0,0
Mike Swick,Alex Garcia,226.9775391,-21,0,-3,0,-3,-8,-3,-5,2,-7,-9,0,0
Santiago Ponzinibbio,Lorenz Larkin,-260.625,7,0,0,0,-1,0,3,-3,6,-9,0,0,0
Augusto Montano,Cathal Pendred,513.25,7,0,2,0,2,2,0,2,-2,4,-3,0,0
Brian Ebersole,Omari Akhmedov,-318.375,-14,0,-3,0,-3,-3,-1,-2,1,-3,-7,-1,0
KJ Noons,Alex Oliveira,459,-6,0,0,0,-2,-2,-1,-1,0,-1,-5,0,0
Carlos Condit,Thiago Alves,-141.6225891,15,-1,0,0,2,7,2,5,-3,8,0,0,2
Dong Hyun Kim,Joshua Burkman,506.043335,-8,0,0,0,-2,-5,2,-7,9,-16,2,-1,2
Mike Pyle,Colby Covington,228.3421631,-23,0,2,-1,-2,-7,-5,-2,-3,1,-12,0,0
Hyun Gyu Lim,Neil Magny,213.9882813,15,0,-1,0,4,4,1,3,-2,5,-3,0,0
Li Jingliang,Dhiego Lima,-588.75,-1,1,-1,1,0,0,1,-1,2,-3,-1,0,2
Vik Grujic,Brendan O'Reilly,508.25,-2,0,0,0,-1,-1,-1,0,-1,1,-11,0,0
Patrick Cote,Joe Riggs,-727.9655457,-26,-2,1,-4,-3,-3,-4,1,-5,6,-3,1,2
Nordine Taleb,Chris Clements,-507.5,3,0,-1,0,-1,0,2,-2,4,-6,6,0,2
George Sullivan,Tim Means,-163.515625,15,0,0,0,1,3,3,0,3,-3,-3,0,0
Pawel Pawlak,Sheldon Westcott,-319,-1,1,0,0,0,0,0,0,0,0,4,1,2
Seth Baczynski,Leon Edwards,369.4296875,-19,0,0,0,-4,-5,-4,-1,-3,2,-10,1,0
Demian Maia,Ryan LaFlare,-38.28724289,-36,-1,-1,0,-1,-9,-6,-3,-3,0,-6,0,2
Erick Silva,Josh Koscheck,209.4768908,37,1,1,0,4,10,5,5,0,5,7,0,2
Johny Hendricks,Matt Brown,-397.2052155,3,-3,-3,0,1,1,3,-2,5,-7,3,-1,2
Jake Ellenberger,Josh Koscheck,-96.7727809,20,1,2,-1,-1,7,3,4,-1,5,8,0,2
Dhiego Lima,Tim Means,401.46875,15,-1,2,-1,1,3,2,1,1,0,5,0,0
Alan Jouban,Richard Walsh,318.5,2,0,0,0,0,0,0,0,0,0,-7,-1,2
Santiago Ponzinibbio,Sean Strickland,96.5,0,0,2,-1,1,1,-1,2,-3,5,-5,0,2
William Macario,Matt Dwyer,-687.75,-7,-1,0,0,-1,-1,-1,0,-1,1,2,0,0
Benson Henderson,Brandon Thatch,-651.484375,-41,-5,-5,0,-5,-7,-3,-4,1,-5,-2,1,2
Neil Magny,Kiichi Kunimoto,-231.2265625,-16,0,2,0,-2,-3,-2,-1,-1,0,6,0,2
Jordan Mein,Thiago Alves,463.4970093,36,1,-1,1,5,9,5,4,1,3,6,0,0
Tyron Woodley,Kelvin Gastelum,191.25,0,1,4,0,3,1,-2,3,-5,8,-9,1,2
Nicholas Musoke,Albert Tumenov,-495.375,-5,0,-2,1,0,-1,0,-1,1,-2,-5,0,0
John Howard,Lorenz Larkin,-163.9550781,-18,0,-4,1,-3,-5,-1,-4,3,-7,-3,0,0
Cathal Pendred,Sean Spencer,183.0625,10,0,-2,1,0,1,2,-1,3,-4,0,0,2
Hector Lombard,Joshua Burkman,157.5976563,13,0,2,-1,0,2,3,-1,4,-5,-2,-1,1
Omari Akhmedov,Mats Nilsson,20.5,-1,0,-1,1,-1,-1,0,-1,1,-2,4,0,2
Erick Silva,Mike Rhodes,424.0078125,-7,0,-1,2,-1,-4,-2,-2,0,-2,-5,0,2
Marcio Alexandre Junior,Tim Means,248.9375,13,-1,2,-1,2,3,2,1,1,0,5,-1,0
Joe Riggs,Ben Saunders,273.1953125,4,0,2,0,2,1,-1,2,-3,5,-1,-1,0
Johny Hendricks,Robbie Lawler,-69.59277344,-1,-1,-1,0,-3,-2,2,-4,6,-10,1,0,0
Jake Ellenberger,Kelvin Gastelum,78.3125,-18,1,4,-1,-2,-4,-4,0,-4,4,-6,1,0
Warlley Alves,Alan Jouban,-362,-2,-1,0,0,0,0,0,0,0,0,9,1,2
Wagner Silva,Colby Covington,-76,-1,0,1,-1,1,1,-1,2,-3,5,-1,0,0
Vik Grujic,Chris Clements,1.5,4,0,1,-1,0,0,1,-1,2,-3,1,0,0
William Macario,Neil Magny,35.453125,13,-1,1,-1,3,4,1,3,-2,5,4,0,0
Nordine Taleb,Li Jingliang,0,0,0,0,0,0,0,0,0,0,0,-7,0,2
Rory MacDonald,Tarec Saffiedine,613.640625,-20,0,0,0,-4,-7,-2,-5,3,-8,3,2,2
Nicholas Musoke,Alexander Yakovlev,178.25,-4,0,-2,1,-2,-2,0,-2,2,-4,2,1,2
Cathal Pendred,Gasan Umalatov,387,4,0,-1,1,0,0,1,-1,2,-3,5,0,2
Gunnar Nelson,Rick Story,129.5431213,34,0,-4,1,2,6,6,0,6,-6,4,-1,0
Patrick Cote,Stephen Thompson,-394.8764038,-26,-2,1,-4,-1,-3,-7,4,-11,15,-3,0,0
John Howard,Brian Ebersole,-11.16015625,-12,0,0,0,0,-2,-2,0,-2,2,2,1,0
Kiichi Kunimoto,Richard Walsh,725.5,1,0,-1,0,-1,-1,0,-1,1,-2,-8,0,2
Yoshihiro Akiyama,Amir Sadollah,170.5839844,12,1,0,0,1,5,0,5,-5,10,-5,0,2
Hyun Gyu Lim,Takenori Sato,-892.5,-7,0,-2,1,-2,-2,0,-2,2,-4,0,1,2
Igor Araujo,George Sullivan,0,-3,0,-1,0,-1,-1,0,-1,1,-2,0,0,0
Paulo Thiago,Sean Spencer,199.7241211,-17,0,-1,1,0,-3,-5,2,-7,9,-6,0,0
Mike Pyle,Jordan Mein,43.18432617,-20,0,1,-1,-3,-7,-3,-4,1,-5,-14,0,0
Neil Magny,Alex Garcia,-182.40625,-11,0,1,0,-1,-2,-2,0,-2,2,0,0,2
Tyron Woodley,Dong Hyun Kim,-4.364013672,24,0,1,0,2,7,1,6,-5,11,0,1,2
Sai Wang,Danny Mitchell,0,0,-1,0,0,0,0,0,0,0,0,0,-1,2
Robbie Lawler,Matt Brown,-434.0708313,9,-1,-2,0,4,4,1,3,-2,5,1,-1,2
Hernani Perpetuo,Tim Means,-52.125,10,0,2,-1,2,2,2,0,2,-2,1,0,0
Gunnar Nelson,Zak Cummings,163,-1,0,-1,0,-1,-1,0,-1,1,-2,4,-1,2
Rick Story,Leonardo Mafra,-190.5862427,-36,0,0,0,-6,-9,-5,-4,-1,-3,-4,-1,2
Kenny Robertson,Ildemar Alcantara,468.4375,1,0,2,-2,1,1,-2,3,-5,8,1,0,2
Kelvin Gastelum,Nicholas Musoke,-168,-3,-1,-1,0,-1,-1,0,-1,1,-2,6,-1,2
Chris Indich,Vik Grujic,0,0,0,0,0,0,0,0,0,0,0,10,-3,0
Robert Whittaker,Mike Rhodes,370.875,-7,-1,-2,1,-2,-2,-1,-1,0,-1,1,0,2
Rory MacDonald,Tyron Woodley,-476.21875,-15,0,0,0,-3,-4,-1,-3,2,-5,8,0,2
Daniel Sarafian,Kiichi Kunimoto,-533,-6,0,1,-1,0,0,-2,2,-4,6,2,0,0
Bobby Voelker,Lance Benoist,144,1,0,1,-3,1,1,-1,2,-3,5,-10,1,0
Paulo Thiago,Gasan Umalatov,441.1982422,-23,0,-1,1,-2,-5,-5,0,-5,5,-2,0,0
Robbie Lawler,Jake Ellenberger,-382.1376953,0,-1,-3,1,3,1,-1,2,-3,5,-3,-1,2
Neil Magny,Tim Means,-15.875,0,0,1,0,1,0,0,0,0,0,4,0,2
Matt Brown,Erick Silva,-16.88665771,-24,0,0,0,-5,-7,-2,-5,3,-8,-4,0,2
Yan Cabral,Zak Cummings,-641,-2,0,0,0,0,0,0,0,0,0,-1,1,0
Anthony Lapsley,Albert Tumenov,0,0,0,0,0,0,0,0,0,0,0,-12,-1,0
Thiago Alves,Seth Baczynski,-13.21276855,-22,-1,0,0,-3,-6,-3,-3,0,-3,2,0,2
Patrick Cote,Kyle Noke,-362.4090576,-23,-2,3,-4,-1,-2,-6,4,-10,14,0,1,2
Sam Stout,KJ Noons,8.480865479,-41,0,-1,1,-1,-8,-7,-1,-6,5,2,0,0
John Howard,Ryan LaFlare,17.1796875,-16,0,-1,0,-1,-3,-3,0,-3,3,-1,1,0
Thiago Perpetuo,Kenny Robertson,221.875,5,0,-1,2,0,0,2,-2,4,-6,4,0,0
Carlos Condit,Tyron Woodley,-633.9921875,-23,-2,1,-1,-4,-4,-2,-2,0,-2,2,0,0
Kelvin Gastelum,Rick Story,240.1724854,32,-1,-2,1,4,7,5,2,3,-1,7,0,2
Johny Hendricks,Robbie Lawler,-455.6665039,-9,-1,-1,0,-3,-3,1,-4,5,-9,1,0,2
Jake Shields,Hector Lombard,-764.15625,-15,-1,-1,1,-1,-2,-1,-1,0,-1,1,1,0
Sean Spencer,Alex Garcia,-815.25,-8,0,1,-1,-1,-1,-1,0,-1,1,0,0,0
Gunnar Nelson,Omari Akhmedov,-346,-3,0,-1,0,-1,-1,0,-1,1,-2,1,-2,2
Dong Hyun Kim,John Hathaway,269.3530273,-9,0,2,0,1,-2,-2,0,-2,2,-6,-1,2
Robert Whittaker,Stephen Thompson,-272.625,0,-1,-1,0,0,1,0,1,-1,2,8,0,0
Rory MacDonald,Demian Maia,207.7114716,23,1,4,0,0,6,3,3,0,3,12,1,2
Mike Pyle,TJ Waldburger,28.10302734,-11,0,1,-1,-2,-4,-1,-3,2,-5,-13,0,2
Viscardi Andrade,Nicholas Musoke,91,0,0,0,0,0,0,0,0,0,0,-2,0,0
William Macario,Bobby Voelker,29,3,-1,0,1,0,0,1,-1,2,-3,12,0,2
John Howard,Siyar Bahadurzada,-394.640625,-18,0,-3,0,-3,-4,-2,-2,0,-2,-1,0,2
Court McGee,Ryan LaFlare,9.34375,-14,-1,-1,0,-1,-3,-2,-1,-1,0,1,1,0
Josh Koscheck,Tyron Woodley,-73.89193821,-44,-1,-1,0,-4,-14,-6,-8,2,-10,-4,0,0
Georges St-Pierre,Johny Hendricks,-878.7553253,-39,-13,2,0,-5,-8,-1,-7,6,-13,-2,1,2
Brian Ebersole,Rick Story,-234.1550293,20,0,-4,1,2,4,4,0,4,-4,-3,0,0
Rory MacDonald,Robbie Lawler,-486.8242188,1,0,2,0,-2,0,2,-2,4,-6,7,1,0
Paulo Thiago,Brandon Thatch,-704.6035156,-24,0,0,0,-1,-4,-5,1,-6,7,-4,2,0
Neil Magny,Seth Baczynski,-53.9375,11,0,-1,1,3,3,2,1,1,0,6,0,0
Nate Marquardt,Hector Lombard,251.392334,-26,-1,-4,1,-3,-9,-3,-6,3,-9,1,1,0
TJ Waldburger,Adlan Amagov,440.53125,-8,0,0,0,-1,-3,-2,-1,-1,0,1,0,0
Rousimar Palhares,Mike Pierce,355.0839844,14,0,0,0,1,2,-1,3,-4,7,0,0,2
Erick Silva,Dong Hyun Kim,471.6064453,22,0,1,0,2,5,1,4,-3,7,2,1,0
Demian Maia,Jake Shields,259.5145569,-19,0,-4,0,-4,-9,-1,-8,7,-15,-1,-1,0
Chris Clements,Stephen Thompson,-72.75,1,0,0,0,0,1,0,1,-1,2,-7,0,0
Yuri Villefort,Sean Spencer,-167,0,0,0,0,0,0,0,0,0,0,4,0,0
Pascal Krauss,Hyun Gyu Lim,-360,-7,0,0,0,0,-1,-1,0,-1,1,2,0,0
Court McGee,Robert Whittaker,-110.8125,-11,0,-1,0,-1,-2,-2,0,-2,2,-6,0,2
Kelvin Gastelum,Brian Melancon,-601,-2,-1,0,0,0,0,0,0,0,0,10,-1,2
Carlos Condit,Martin Kampmann,-722.5658264,8,-2,4,-1,-1,6,2,4,-2,6,2,0,2
James Head,Jason High,67.25,-4,0,0,1,-2,-2,0,-2,2,-4,2,1,0
Matt Brown,Mike Pyle,107.5206299,-11,0,-1,1,-1,-2,-2,0,-2,2,5,0,2
Sergio Moraes,Neil Magny,55,-3,-1,1,-1,0,0,-1,1,-2,3,-5,0,2
Robbie Lawler,Bobby Voelker,615.8984375,-12,0,-3,1,-3,-5,-2,-3,1,-4,3,-1,2
Rory MacDonald,Jake Ellenberger,-244,9,0,-1,1,2,3,1,2,-1,3,4,0,2
Mike Pierce,David Mitchell,147.6367188,-22,0,-1,2,-2,-7,-1,-6,5,-11,1,0,2
Sean Pierson,Kenny Robertson,-458.125,-7,0,-1,2,-1,-2,0,-2,2,-4,-8,-1,2
Jake Shields,Tyron Woodley,-795.625,-14,-1,0,0,0,-1,-3,2,-5,7,-3,0,2
Erick Silva,Jason High,373.125,-3,0,-1,1,-1,-2,-1,-1,0,-1,3,1,2
Colton Smith,Robert Whittaker,0,0,0,0,0,0,0,0,0,0,0,-3,0,0
Mike Pyle,Rick Story,144.1645508,11,0,0,0,3,1,1,0,1,-1,-9,1,2
Stephen Thompson,Nah-Shon Burrell,323.5,-1,0,0,0,0,0,-1,1,-2,3,-7,0,2
Matt Brown,Jordan Mein,-251.4841309,-30,0,0,0,-3,-8,-5,-3,-2,-1,-9,0,2
Papy Abedi,Besam Yousef,213.5,0,0,0,-1,0,0,-1,1,-2,3,-6,-1,2
Jake Ellenberger,Nate Marquardt,80.71533203,11,1,4,-1,-2,3,2,1,1,0,6,0,2
Carlos Condit,Johny Hendricks,-889.2011719,0,-2,4,-1,0,4,-1,5,-6,11,1,1,0
Georges St-Pierre,Nick Diaz,-362.0111389,-26,-11,0,0,-7,-10,3,-13,16,-29,-2,1,2
Dong Hyun Kim,Siyar Bahadurzada,-599.0878906,-25,0,-1,0,-2,-6,-3,-3,0,-3,-3,-1,2
Court McGee,Josh Neer,-652.744751,16,-1,-3,1,-1,3,6,-3,9,-12,1,0,2
Josh Koscheck,Robbie Lawler,-515.5807514,-33,-1,1,0,-2,-11,-3,-8,5,-13,-5,1,0
Kenny Robertson,Brock Jardine,285.5,-2,0,0,-1,0,0,-1,1,-2,3,-2,0,2
Gunnar Nelson,Jorge Santiago,503.125,10,0,0,0,0,0,4,-4,8,-12,8,-2,2
Che Mills,Matthew Riddle,654.4257813,28,0,2,0,2,5,3,2,1,1,-3,1,1
Jon Fitch,Demian Maia,-366.380722,-13,0,-3,0,-3,-3,1,-4,5,-9,1,1,0
Mike Stumpf,Pascal Krauss,668,5,0,1,-1,1,1,0,1,-1,2,-1,-3,0
Simeon Thoresen,David Mitchell,547,3,0,-1,2,-1,-1,1,-2,3,-5,5,0,0
TJ Waldburger,Nick Catone,222.4375,7,0,0,0,0,0,1,-1,2,-3,7,1,2
Mike Pyle,James Head,419.4492188,-11,0,0,0,-1,-4,-2,-2,0,-2,-9,0,2
Mike Pierce,Seth Baczynski,-132.4765625,-17,0,-1,1,1,-3,-2,-1,-1,0,-1,0,2
BJ Penn,Rory MacDonald,-392.4271326,-52,-11,-2,0,0,-8,-8,0,-8,8,-10,0,0
Mike Swick,Matt Brown,149.4233398,3,0,-4,0,-2,-2,2,-4,6,-10,-2,0,0
Johny Hendricks,Martin Kampmann,13.30194092,11,0,0,0,0,3,3,0,3,-3,1,-1,2
Georges St-Pierre,Carlos Condit,-536.6189575,-37,-10,-2,1,-4,-11,-1,-10,9,-19,-3,0,2
Matthew Riddle,John Maguire,23.1484375,-21,0,-1,0,-1,-4,-3,-1,-2,1,3,0,2
Dong Hyun Kim,Paulo Thiago,68.23828125,-4,0,-1,0,-1,-2,1,-3,4,-7,1,-1,2
Demian Maia,Rick Story,415.5679932,-5,-1,-5,1,1,-3,-1,-2,1,-3,-6,0,2
Jon Fitch,Erick Silva,-304.2032166,-41,-1,-7,0,-7,-11,-2,-9,7,-16,-6,0,2
Josh Neer,Justin Edwards,525.239502,-20,0,0,0,-1,-5,-5,0,-5,5,0,0,0
Aaron Simpson,Mike Pierce,-14.16601563,0,0,-2,0,0,-1,0,-1,1,-2,-6,0,0
Jake Ellenberger,Jay Hieron,-107.5,-14,0,0,1,-6,-6,0,-6,6,-12,9,0,2
Che Mills,Duane Ludwig,101.0625,11,0,1,0,1,3,3,0,3,-3,4,0,2
Dan Hardy,Amir Sadollah,314.2265625,-1,0,-3,0,-2,1,-1,2,-3,5,2,0,2
John Hathaway,John Maguire,-150.25,-14,0,-2,0,-2,-4,-1,-3,2,-5,4,1,2
Sean Pierson,Lance Benoist,92.25,-4,0,0,0,0,-1,-1,0,-1,1,-12,0,2
Seth Baczynski,Simeon Thoresen,-238.5,-8,0,1,-1,-2,-2,-1,-1,0,-1,-2,0,2
Kyle Noke,Charlie Brenneman,-94.5625,7,0,-2,0,-1,1,1,0,1,-1,-1,-1,2
Mike Swick,DaMarques Johnson,-130.2382813,-11,1,-5,1,-3,-5,1,-6,7,-13,-3,0,2
Brian Ebersole,James Head,-278,-6,0,-4,1,-3,-3,1,-4,5,-9,-3,-1,0
Chris Clements,Matthew Riddle,-28.296875,23,0,2,0,2,5,3,2,1,1,-10,1,1
Aaron Simpson,Kenny Robertson,-560.2382813,-21,0,-3,1,-3,-6,-2,-4,2,-6,-9,0,2
Dong Hyun Kim,Demian Maia,186.0319824,10,1,3,0,2,3,2,1,1,0,4,0,0
Brian Ebersole,TJ Waldburger,-532.125,-1,0,-2,0,-1,0,1,-1,2,-3,-7,-1,2
Matt Brown,Luis Ramos,-631.9365234,-26,0,-1,1,-3,-7,-4,-3,-1,-2,0,0,2
Dan Miller,Ricardo Funch,-496.7050781,-19,0,-3,3,-3,-5,-2,-3,1,-4,1,1,2
Erick Silva,Charlie Brenneman,665.25,13,0,0,0,1,3,1,2,-1,3,4,0,2
Mike Pyle,Josh Neer,145.4194336,11,0,0,0,-1,1,3,-2,5,-7,-7,0,2
Seth Baczynski,Lance Benoist,411,-4,0,1,-1,-1,-1,-1,0,-1,1,-7,1,2
Mike Pierce,Carlos Eduardo Rocha,-340.40625,-19,0,0,0,-2,-4,-2,-2,0,-2,-1,0,2
Jake Hecht,Sean Pierson,503,4,0,0,0,0,0,1,-1,2,-3,8,1,0
Jake Ellenberger,Martin Kampmann,275.6741943,13,0,4,-1,-2,4,3,1,2,-1,3,0,0
Dan Hardy,Duane Ludwig,-378.7578125,-9,-1,-2,0,-2,0,-1,1,-2,3,3,0,2
Amir Sadollah,Jorge Lopez,110.6640625,-16,-1,-1,1,-2,-5,-2,-3,1,-4,-8,0,2
John Hathaway,Pascal Krauss,19.5,-13,0,-3,0,-3,-4,-1,-3,2,-5,1,0,2
Josh Koscheck,Johny Hendricks,-462.4974403,-27,-1,2,0,-1,-8,-4,-4,0,-4,-6,1,0
Matt Brown,Stephen Thompson,-190.8730469,-23,0,0,0,-2,-5,-5,0,-5,5,-2,0,2
Rory MacDonald,Che Mills,-447,-7,0,0,0,-1,-2,-1,-1,0,-1,7,0,2
DaMarques Johnson,John Maguire,634.296875,-8,-1,1,-1,-1,-3,-3,0,-3,3,-1,1,0
Papy Abedi,James Head,601,2,0,0,0,0,0,0,0,0,0,-5,-1,0
Thiago Alves,Martin Kampmann,296.3603516,-11,-1,4,-1,-3,-2,-1,-1,0,-1,1,0,0
TJ Waldburger,Jake Hecht,5.25,-3,0,0,0,0,-1,-1,0,-1,1,5,0,2
Yoshihiro Akiyama,Jake Shields,123,-1,1,0,0,0,0,-1,1,-2,3,-3,0,0
Diego Sanchez,Jake Ellenberger,-661.3130188,-30,-2,-6,1,-1,-7,-3,-4,1,-5,-4,-1,0
Josh Koscheck,Mike Pierce,134.6769943,-21,-1,-1,0,-2,-9,-3,-6,3,-9,-3,0,2
Matt Brown,Chris Cope,-38.74609375,-18,0,0,0,-2,-4,-4,0,-4,4,-3,0,2
Nick Diaz,Carlos Condit,-372.6591797,-16,0,-2,1,1,-3,-3,0,-3,3,-1,-1,0
Charlie Brenneman,Daniel Roberts,240.09375,0,0,-1,1,1,0,1,-1,2,-3,1,1,2
Duane Ludwig,Josh Neer,4.791992188,15,0,-2,1,0,1,4,-3,7,-10,-5,0,0
Ricardo Funch,Mike Pyle,-119.796875,11,0,0,-1,3,4,1,3,-2,5,5,-1,0
Jon Fitch,Johny Hendricks,-253.7658081,-27,-1,-4,0,-4,-7,-1,-6,5,-11,-5,1,0
Dong Hyun Kim,Sean Pierson,-3.703125,-15,0,-1,0,-2,-4,-1,-3,2,-5,5,0,2
Claude Patrick,Brian Ebersole,-193,-4,0,-1,0,-1,-1,0,-1,1,-2,0,1,0
Rick Story,Martin Kampmann,-36.34228516,1,0,4,-1,-2,2,2,0,2,-2,2,-1,0
Matt Brown,Seth Baczynski,-39.4921875,-15,0,-1,1,-2,-4,-3,-1,-2,1,0,0,0
DaMarques Johnson,Clay Harvison,198.59375,-5,-1,1,-1,-1,-2,-2,0,-2,2,2,0,2
Mike Pierce,Paul Bradley,156.375,-14,0,-1,1,-3,-4,-1,-3,2,-5,-3,0,2
BJ Penn,Nick Diaz,-206.7859058,-35,-11,-1,0,-1,-6,-4,-2,-2,0,-4,1,0
Anthony Johnson,Charlie Brenneman,175.984375,-6,0,0,0,-1,-3,-2,-1,-1,0,3,0,2
Josh Neer,Keith Wisniewski,53.91601563,-22,0,0,0,-2,-4,-5,1,-6,7,1,0,2
Matt Hughes,Josh Koscheck,818.4617193,-10,-11,0,0,-1,-5,-1,-4,3,-7,-4,-2,0
Jake Shields,Jake Ellenberger,-725,4,-1,-1,1,3,3,0,3,-3,6,-6,0,0
Clay Harvison,Seth Baczynski,0,0,0,-1,1,-1,-1,1,-2,3,-5,-1,0,0
Paulo Thiago,David Mitchell,82.34375,-12,0,-1,1,-2,-3,-2,-1,-1,0,1,0,2
Amir Sadollah,Duane Ludwig,-142.171875,-7,-1,1,0,0,-2,0,-2,2,-4,3,0,0
Dan Hardy,Chris Lytle,-15.85511017,26,0,-4,2,0,5,7,-2,9,-11,7,0,0
Dennis Hallman,Brian Ebersole,421.65625,-14,-1,0,0,-1,-2,-4,2,-6,8,-5,1,0
Rory MacDonald,Mike Pyle,94.40625,8,0,-1,1,2,2,1,1,0,1,13,0,2
Johny Hendricks,Mike Pierce,186.96875,1,0,-3,0,-1,-1,0,-1,1,-2,3,-1,2
Carlos Condit,Dong Hyun Kim,309.65625,8,0,2,-1,0,2,0,2,-2,4,2,1,2
Daniel Roberts,Rich Attonito,237.0625,-1,0,2,-1,-1,-1,-1,0,-1,1,4,-1,0
Matt Brown,John Howard,311.578125,-1,0,3,0,1,0,-2,2,-4,6,-2,0,2
Charlie Brenneman,Rick Story,66.078125,11,0,-1,1,5,4,0,4,-4,8,-4,1,2
Thiago Alves,Rick Story,-191.7958984,-17,-1,0,0,-2,-5,-3,-2,-1,-1,-1,1,0
Jake Ellenberger,Sean Pierson,112,-8,0,1,-1,-2,-2,-1,-1,0,-1,9,1,2
Georges St-Pierre,Jake Shields,-553.112915,-45,-10,-1,0,-7,-14,-2,-12,10,-22,3,0,2
Daniel Roberts,Claude Patrick,395.625,-1,0,2,-1,-1,-1,-1,0,-1,1,0,-1,0
Nate Diaz,Rory MacDonald,-197.2070313,-23,-1,-4,0,-4,-7,-3,-4,1,-5,-5,-1,0
DaMarques Johnson,Amir Sadollah,482.53125,6,0,1,-1,0,1,0,1,-1,2,2,0,0
Anthony Johnson,Dan Hardy,299.5,2,1,3,0,1,-1,-1,0,-1,1,1,0,2
John Hathaway,Kris McCray,-530,-10,1,-4,2,-4,-4,1,-5,6,-11,6,0,2
Johny Hendricks,TJ Waldburger,194.4375,-9,0,-3,0,-3,-3,-1,-2,1,-3,-5,-1,2
Ricardo Almeida,Mike Pyle,103.5371094,-10,0,0,0,-1,-3,-2,-1,-1,0,1,0,0
Diego Sanchez,Martin Kampmann,-197.2324829,-20,-2,-2,0,-2,-3,-1,-2,1,-3,-1,-1,2
BJ Penn,Jon Fitch,184.1043358,-16,-10,5,0,5,1,-6,7,-13,20,1,0,1
Jake Ellenberger,Carlos Eduardo Rocha,-535,-7,0,1,-1,-1,-1,-1,0,-1,1,4,0,2
DaMarques Johnson,Mike Guymon,-205.375,-2,-1,0,0,-1,-1,0,-1,1,-2,8,0,2
Charlie Brenneman,Amilcar Alves,171,-2,0,-1,1,-1,-1,0,-1,1,-2,-7,1,2
Nate Diaz,Dong Hyun Kim,228.3984375,-9,-1,-3,0,-3,-4,-2,-2,0,-2,4,0,0
Daniel Roberts,Greg Soto,503.25,1,0,0,0,-1,-1,0,-1,1,-2,-6,-1,2
Thiago Alves,John Howard,-362.7792969,-17,-1,4,-1,-3,-5,-3,-2,-1,-1,0,0,2
Georges St-Pierre,Josh Koscheck,-755.6838074,-8,-9,0,0,-2,-1,2,-3,5,-8,4,0,2
TJ Grant,Ricardo Almeida,-394.0742188,6,0,-1,1,2,2,2,0,2,-2,8,0,0
Johny Hendricks,Rick Story,93.1875,4,0,-4,1,0,0,1,-1,2,-3,-1,0,0
Karo Parisyan,Dennis Hallman,98.82617188,-15,1,0,0,-3,-6,0,-6,6,-12,6,0,0
Matt Brown,Brian Foster,-302.96875,-9,0,-1,1,-2,-2,-1,-1,0,-1,-3,0,0
Matt Hughes,BJ Penn,933.7984767,6,-1,1,0,-3,-7,2,-9,11,-20,-6,-2,0
Amir Sadollah,Peter Sobotta,99.3125,-5,-1,-1,2,-2,-3,0,-3,3,-6,-7,1,2
Duane Ludwig,Nick Osipczak,633.625,4,0,0,0,0,0,0,0,0,0,-7,0,2
Mike Guymon,Daniel Roberts,-73,0,0,0,0,0,0,0,0,0,0,-6,1,0
Diego Sanchez,Paulo Thiago,-265.9395752,-25,-2,-5,0,-4,-7,-2,-5,3,-8,1,-1,2
John Hathaway,Mike Pyle,-184.375,-1,0,-4,1,-3,-2,2,-4,6,-10,12,0,0
Dan Hardy,Carlos Condit,-251.5625,-6,-1,-4,1,-2,-2,0,-2,2,-4,-2,0,0
James Wilks,Claude Patrick,-302.25,-5,-1,0,0,0,-1,-1,0,-1,1,-2,0,0
Matt Serra,Chris Lytle,13.30929565,7,-2,0,1,1,1,3,-2,5,-7,0,0,0
TJ Grant,Julio Paulino,150.75,-7,0,-1,1,-1,-2,-1,-1,0,-1,8,0,2
Brian Foster,Forrest Petz,612.1875,11,0,1,-1,0,1,2,-1,3,-4,8,0,2
Nate Diaz,Marcus Davis,-25.15795898,4,-1,-5,1,1,2,1,1,0,1,12,0,2
Nick Osipczak,Greg Soto,-23.25,-4,0,-2,1,-2,-2,0,-2,2,-4,-1,0,0
Jon Fitch,Thiago Alves,160.1828613,-10,0,-8,1,-1,-3,2,-5,7,-12,-6,0,2
Matt Hughes,Ricardo Almeida,-124.1356058,-30,-12,-2,1,-3,-12,-2,-10,8,-18,-3,-2,2
Johny Hendricks,Charlie Brenneman,217.75,-4,0,-2,0,-2,-2,0,-2,2,-4,3,-1,2
Dustin Hazelett,Rick Story,590.7578125,-1,0,0,0,0,-2,-2,0,-2,2,1,1,0
Ben Saunders,Dennis Hallman,183.5625,1,1,-2,0,-2,-3,2,-5,7,-12,7,0,0
DaMarques Johnson,Matthew Riddle,280,10,-1,3,-1,1,2,0,2,-2,4,-4,1,0
John Howard,Jake Ellenberger,101.75,-5,0,-4,1,-3,-3,1,-4,5,-9,-2,0,0
Chris Lytle,Matt Brown,38.65338135,-24,-1,1,-2,1,-3,-7,4,-11,15,-6,0,2
Forrest Petz,Daniel Roberts,-741.375,-12,0,-1,1,-1,-2,-2,0,-2,2,-5,1,0
Paulo Thiago,Martin Kampmann,-257.0507813,5,0,3,0,2,4,1,3,-2,5,-1,0,0
Carlos Condit,Rory MacDonald,-633,-5,0,1,-1,0,0,-1,1,-2,3,-6,0,2
James Wilks,Peter Sobotta,379.5,-1,-1,-1,1,-1,-1,0,-1,1,-2,-9,1,2
Mike Pyle,Jesse Lennox,467.25,0,0,1,-1,0,0,-1,1,-2,3,-6,0,2
Diego Sanchez,John Hathaway,-358.5041504,-27,-2,-3,0,-3,-7,-3,-4,1,-5,-6,-1,0
Amir Sadollah,Dong Hyun Kim,164.25,4,-1,1,0,0,0,0,0,0,0,-1,1,0
Marcus Davis,Jonathan Goulet,-310.0981445,-10,0,1,-1,-4,-4,0,-4,4,-8,-6,-1,2
Josh Koscheck,Paul Daley,-253.5840454,-30,0,0,0,-3,-10,-4,-6,2,-8,-5,0,2
TJ Grant,Johny Hendricks,-134,-3,0,1,0,1,0,-1,1,-2,3,0,1,0
Yoshiyuki Yoshida,Mike Guymon,186.625,-3,0,-1,1,-1,-2,-1,-1,0,-1,0,-1,0
Nick Osipczak,Rick Story,240.75,4,0,-2,1,0,0,1,-1,2,-3,0,1,0
DaMarques Johnson,Brad Blackburn,575.125,9,-1,3,-1,2,2,0,2,-2,4,5,0,2
Ricardo Almeida,Matt Brown,-292.328125,-5,0,1,-1,1,0,-2,2,-4,6,-4,0,2
Nate Diaz,Rory Markham,-683.65625,-18,-1,-4,0,-4,-5,-2,-3,1,-4,4,-1,2
Georges St-Pierre,Dan Hardy,-516.3266602,-28,-8,2,0,-2,-9,-2,-7,5,-12,-1,0,2
Ben Saunders,Jon Fitch,599.6264648,25,1,5,0,5,7,0,7,-7,14,6,0,0
Chris Lytle,Brian Foster,-424.5682373,-32,-1,0,-1,-1,-5,-8,3,-11,14,-10,0,2
Matt Serra,Frank Trigg,-556.0717773,-24,-1,0,0,0,-4,-2,-2,0,-2,2,1,2
Paulo Thiago,Mike Swick,-35.0703125,15,0,4,0,4,7,1,6,-5,11,1,0,2
Rick Story,Jesse Lennox,182.5,-2,0,1,-1,0,0,-1,1,-2,3,2,-1,2
Amir Sadollah,Brad Blackburn,284.5,3,-1,2,0,2,1,-1,2,-3,5,3,0,2
Martin Kampmann,Jacob Volkmann,515.8515625,-10,0,-4,1,-4,-6,-1,-5,4,-9,2,1,2
Paul Daley,Dustin Hazelett,190.734375,10,0,-1,1,2,4,2,2,0,2,-3,0,2
Jake Ellenberger,Mike Pyle,-439.5,1,0,0,0,1,1,0,1,-1,2,10,0,2
Jon Fitch,Mike Pierce,-62.50292969,-28,-1,-7,0,-7,-9,-1,-8,7,-15,-2,0,2
DaMarques Johnson,Edgar Garcia,606,2,-1,0,0,0,0,0,0,0,0,-2,0,2
TJ Grant,Kevin Burns,-124.875,5,0,1,0,1,1,1,0,1,-1,4,0,2
John Howard,Dennis Hallman,-196.25,4,1,-1,0,-1,-1,3,-4,7,-11,8,0,2
Ben Saunders,Marcus Davis,337.4306641,14,0,-3,1,3,5,2,3,-1,4,10,1,2
Josh Koscheck,Anthony Johnson,13.89440918,-18,0,-1,0,-2,-6,-2,-4,2,-6,-6,0,2
Brian Foster,Brock Larson,255.125,9,0,0,0,3,3,1,2,-1,3,7,1,2
Amir Sadollah,Phil Baroni,655.578125,15,-1,0,0,1,2,4,-2,6,-8,4,0,2
Nick Osipczak,Matthew Riddle,680,8,0,2,0,2,2,0,2,-2,4,-1,1,2
John Hathaway,Paul Taylor,283.59375,12,0,-1,0,-1,1,3,-2,5,-7,7,0,2
Matt Brown,James Wilks,-18.75,-7,1,0,0,-1,-2,-1,-1,0,-1,3,0,2
Dan Hardy,Mike Swick,-207.890625,12,0,2,0,2,6,1,5,-4,9,3,0,2
Anthony Johnson,Yoshiyuki Yoshida,-297.375,-8,0,0,0,-1,-2,-1,-1,0,-1,10,1,2
Josh Koscheck,Frank Trigg,-75.14868164,-23,2,-2,1,-3,-8,-1,-7,6,-13,6,1,2
Mike Pyle,Chris Wilson,714,8,0,0,0,1,1,1,0,1,-1,-1,0,2
John Howard,Tamdan McCrory,-562.5625,6,0,0,0,0,2,2,0,2,-2,-4,2,2
Matthew Riddle,Dan Cramer,0,-3,0,-1,0,-1,-1,0,-1,1,-2,0,-1,2
Jon Fitch,Paulo Thiago,-816.0058594,-27,-1,-7,0,-7,-8,-1,-7,6,-13,-3,0,2
Georges St-Pierre,Thiago Alves,-473.2861328,-11,-7,-2,1,2,-3,0,-3,3,-6,-3,0,2
Dong Hyun Kim,TJ Grant,68.75,-6,0,-1,0,-1,-1,-1,0,-1,1,-2,-1,2
Chris Lytle,Kevin Burns,-172.8864746,-25,-1,2,-2,0,-3,-8,5,-13,18,-5,0,2
Dan Hardy,Marcus Davis,208.8613281,15,0,-2,1,4,6,2,4,-2,6,8,1,2
Mike Swick,Ben Saunders,-50.21875,-11,0,-2,0,-2,-5,-1,-4,3,-7,-3,0,2
Matt Hughes,Matt Serra,66.38238144,-14,-9,-2,1,-4,-9,0,-9,9,-18,-1,-2,2
Yoshiyuki Yoshida,Brandon Wolff,13.5,-1,0,-1,1,-1,-1,0,-1,1,-2,-2,-1,2
Matt Brown,Pete Sell,249.71875,8,0,0,0,0,0,3,-3,6,-9,-2,0,2
Dan Hardy,Rory Markham,-803,-2,0,0,0,0,0,0,0,0,0,0,0,2
Paul Kelly,Troy Mandaloniz,-408,-4,0,0,0,0,0,-1,1,-2,3,5,0,2
Anthony Johnson,Luigi Fioravanti,303.8671875,9,0,-1,1,1,1,2,-1,3,-4,4,0,2
Matthew Riddle,Steve Bruno,-188,2,0,-1,1,0,0,1,-1,2,-3,4,-1,2
Georges St-Pierre,BJ Penn,-300.4606934,3,0,1,0,-2,-2,2,-4,6,-10,3,0,2
Jon Fitch,Akihiro Gono,-450.5117188,-20,-1,-7,0,-7,-7,0,-7,7,-14,4,2,2
Karo Parisyan,Dong Hyun Kim,160.7773438,-22,0,1,0,-2,-6,-3,-3,0,-3,1,1,1
Marcus Davis,Chris Lytle,259.550293,14,1,0,1,-4,-2,6,-8,14,-22,-1,-1,2
Brad Blackburn,Ryo Chonan,451,4,0,-1,1,0,0,1,-1,2,-3,1,0,2
Anthony Johnson,Kevin Burns,190,-2,0,1,0,1,0,-2,2,-4,6,4,0,2
Steve Bruno,Johnny Rees,-639,-2,0,0,0,0,0,0,0,0,0,-1,0,2
Josh Koscheck,Yoshiyuki Yoshida,-772.3447266,-26,0,-1,0,-4,-8,-3,-5,2,-7,3,1,2
Luigi Fioravanti,Brodie Farber,-721.234375,-15,0,0,0,-2,-3,-3,0,-3,3,1,0,2
Mike Swick,Jonathan Goulet,-502.953125,-4,0,-4,0,-3,-3,2,-5,7,-12,0,0,2
Dustin Hazelett,Tamdan McCrory,236.28125,-3,0,1,-1,-2,-2,-1,-1,0,-1,0,2,2
Matt Brown,Ryan Thomas,-262,-3,0,-1,1,-1,-1,0,-1,1,-2,-3,0,2
Thiago Alves,Josh Koscheck,353.4550781,5,0,2,-1,-1,1,0,1,-1,2,5,0,2
Pete Sell,Joshua Burkman,67.5078125,9,0,1,0,1,4,0,4,-4,8,2,0,2
Chris Lytle,Paul Taylor,193.8291016,-17,-1,1,-2,-1,-2,-6,4,-10,14,-6,0,2
Marcus Davis,Paul Kelly,362.5546875,-11,0,1,-1,-5,-5,-2,-3,1,-4,-11,-1,2
Dong Hyun Kim,Matt Brown,-105,-1,0,0,0,0,0,0,0,0,0,1,-1,2
Ryo Chonan,Roan Carneiro,-348.375,6,0,1,-1,1,2,1,1,0,1,-1,0,2
Tamdan McCrory,Luke Cummo,185.375,11,1,-1,1,1,2,2,0,2,-2,7,-2,2
Georges St-Pierre,Jon Fitch,200.4101563,-4,-5,6,0,3,-2,-2,0,-2,2,3,0,2
Kevin Burns,Anthony Johnson,-380,2,0,0,0,0,1,1,0,1,-1,-4,0,2
Josh Koscheck,Chris Lytle,-328.2871094,3,1,-2,2,-3,-4,5,-9,14,-23,3,0,2
Dustin Hazelett,Joshua Burkman,578.953125,11,0,2,-1,-1,2,1,1,0,1,6,0,2
Diego Sanchez,Luigi Fioravanti,252.4023438,-7,-1,-6,1,-4,-4,1,-5,6,-11,1,-1,2
Mike Swick,Marcus Davis,-625.984375,-2,0,-5,1,1,0,0,0,0,0,6,1,2
Thiago Alves,Matt Hughes,195.4285965,23,12,2,-1,1,8,2,6,-4,10,10,2,2
Paul Taylor,Jess Liaudin,-558,-4,0,1,0,1,1,-1,2,-3,5,-28,0,2
Georges St-Pierre,Matt Serra,-64.56445313,4,-2,-2,1,-3,-3,2,-5,7,-12,7,0,2
Jonathan Goulet,Kuniyoshi Hironaka,454.03125,-2,0,-1,1,0,-2,-1,-1,0,-1,3,0,2
Thiago Alves,Karo Parisyan,314.5078125,11,0,1,-1,0,2,0,2,-2,4,1,0,2
Anthony Johnson,Tommy Speer,-128,-2,1,-1,1,-1,-1,0,-1,1,-2,-1,0,2
George Sotiropoulos,Roman Mitichyan,-73,0,0,0,0,0,0,0,0,0,0,-1,0,2
Josh Koscheck,Dustin Hazelett,-620.8828125,-13,0,-2,1,-2,-4,-1,-3,2,-5,-9,0,2
Luigi Fioravanti,Luke Cummo,-285.1875,2,1,0,0,0,1,-1,2,-3,5,0,0,2
Mike Swick,Joshua Burkman,162.03125,6,0,-3,0,-3,0,1,-1,2,-3,-1,0,2
Marcus Davis,Jess Liaudin,-120.28125,-8,0,2,-1,-3,-3,-1,-2,1,-3,-34,-1,2
Georges St-Pierre,Matt Hughes,51.34156799,18,8,0,0,1,7,1,6,-5,11,8,2,2
Roan Carneiro,Tony DeSouza,-289.0625,4,0,1,0,1,2,1,1,0,1,4,1,2
Thiago Alves,Chris Lytle,-55.5078125,8,1,0,1,-1,-2,4,-6,10,-16,9,0,2
Joshua Burkman,Forrest Petz,-2.8125,-3,0,-1,0,-1,-2,0,-2,2,-4,5,0,2
Rich Clementi,Anthony Johnson,-752.5,-9,0,1,-2,0,0,-3,3,-6,9,-8,-1,2
Jon Fitch,Diego Sanchez,182.171875,2,1,0,0,0,0,1,-1,2,-3,-4,1,2
Thiago Alves,Kuniyoshi Hironaka,384.25,-5,0,0,0,-1,-3,-1,-2,1,-3,8,0,2
Luke Cummo,Edilberto de Oliveira,-45.5,-8,-1,0,0,-1,-2,-1,-1,0,-1,-3,0,2
Dustin Hazelett,Jonathan Goulet,64.125,3,0,1,-1,-1,0,1,-1,2,-3,7,0,2
Marcus Davis,Paul Taylor,319.4375,-6,0,1,-1,-3,-3,-1,-2,1,-3,-7,-1,2
Jess Liaudin,Anthony Torres,76,0,0,0,0,0,0,0,0,0,0,29,0,2
Georges St-Pierre,Josh Koscheck,416.609375,-1,-3,0,0,0,0,-1,1,-2,3,3,0,2
Chris Lytle,Jason Gilliam,-719.734375,-19,-1,0,-1,-2,-2,-5,3,-8,11,-32,0,2
Jon Fitch,Roan Carneiro,266.8125,-9,0,-4,0,-4,-4,0,-4,4,-8,0,0,2
Forrest Petz,Luigi Fioravanti,-291.625,0,0,-1,1,1,1,0,1,-1,2,-5,0,2
Karo Parisyan,Joshua Burkman,-62.65625,-10,0,1,0,-2,-2,-1,-1,0,-1,3,0,2
Matt Serra,Georges St-Pierre,-361.5117188,-9,1,2,-1,3,2,-3,5,-8,13,-7,0,2
Josh Koscheck,Diego Sanchez,-206.5,0,1,4,0,2,0,-1,1,-2,3,-4,1,2
Marcus Davis,Pete Spratt,-357.875,1,0,1,-1,-1,1,1,0,1,-1,3,-1,2
Luke Cummo,Josh Haynes,-173,-4,0,0,1,-1,-1,0,-1,1,-2,3,0,2
Kuniyoshi Hironaka,Forrest Petz,-301,1,0,1,-1,1,1,0,1,-1,2,1,0,2
Drew Fickett,Keita Nakamura,205.65625,-9,0,0,0,-2,-3,-2,-1,-1,0,-5,1,2
Matt Hughes,Chris Lytle,255.879364,-18,-10,-2,2,-4,-12,2,-14,16,-30,-1,-2,2
Jon Fitch,Luigi Fioravanti,-350.625,-5,0,-4,1,-2,-2,1,-3,4,-7,-3,0,2
Rich Clementi,Ross Pointon,-625,-4,0,0,-1,0,0,-1,1,-2,3,-4,-1,2
Thiago Alves,Tony DeSouza,-342.625,-2,0,2,-1,0,0,-1,1,-2,3,9,1,2
Luigi Fioravanti,Dave Menne,70,10,2,2,-1,1,1,2,-1,3,-4,7,0,2
Diego Sanchez,Joe Riggs,-579.546875,-1,-1,-4,0,-4,-1,3,-4,7,-11,0,0,2
Marcus Davis,Shonie Carter,-6.125,7,0,3,-1,2,2,1,1,0,1,1,0,2
Karo Parisyan,Drew Fickett,-246.875,-8,0,-1,1,-2,-2,0,-2,2,-4,2,0,2
Georges St-Pierre,Matt Hughes,-122.446228,19,9,0,0,2,8,1,7,-6,13,8,2,2
Pete Spratt,Jeremy Jackson,524.25,-2,0,-1,1,-1,-2,-1,-1,0,-1,-11,0,2
Matt Serra,Chris Lytle,-333.7109375,-8,0,0,1,0,-2,0,-2,2,-4,0,0,2
Thiago Alves,John Alessio,228.5,-1,1,0,1,-2,-2,0,-2,2,-4,4,0,2
Marcus Davis,Forrest Petz,425,1,0,1,-1,1,1,-1,2,-3,5,-2,-1,2
Matt Hughes,BJ Penn,521.1776123,-8,-6,1,0,-3,-7,1,-8,9,-17,-5,-2,2
Nick Diaz,Josh Neer,-104.8984375,-11,0,-2,1,0,-2,-2,0,-2,2,0,-1,2
Joe Riggs,Jason Von Flue,420.46875,-4,0,0,0,0,-2,-2,0,-2,2,8,-1,2
Diego Sanchez,Karo Parisyan,-177,5,-1,-3,0,0,1,1,0,1,-1,-1,-1,2
Josh Koscheck,Jonathan Goulet,-16.375,-2,0,-1,0,-1,-2,0,-2,2,-4,-1,0,2
Joshua Burkman,Josh Neer,218.25,1,0,-2,1,0,0,0,0,0,0,-3,0,2
Jonathan Goulet,Luke Cummo,564.5,2,1,-1,1,0,0,0,0,0,0,0,0,2
Jon Fitch,Thiago Alves,-479.5,-1,0,-2,1,0,0,1,-1,2,-3,-6,0,2
Josh Koscheck,Dave Menne,26.75,5,2,0,0,0,-1,1,-2,3,-5,3,0,2
Diego Sanchez,John Alessio,-193.25,-4,0,-3,1,-3,-3,1,-4,5,-9,2,-1,2
Sean Sherk,Nick Diaz,12.109375,3,-1,-1,0,-1,1,1,0,1,-1,-10,1,2
Karo Parisyan,Nick Thompson,41.75,-10,0,0,0,-2,-3,-1,-2,1,-3,1,0,2
Luke Cummo,Jason Von Flue,-223,0,-1,1,-1,1,1,-1,2,-3,5,5,0,2
Josh Koscheck,Ansar Chalangov,-382.5,-4,0,-2,1,-2,-2,0,-2,2,-4,-2,0,2
Jon Fitch,Joshua Burkman,-856,-1,0,1,0,1,1,0,1,-1,2,-3,0,2
Josh Neer,Joe Stevenson,722.5,1,1,1,-1,0,0,-1,1,-2,3,0,0,2
Georges St-Pierre,BJ Penn,247.8203125,8,2,1,0,0,1,1,0,1,-1,3,0,2
Joe Riggs,Nick Diaz,302.96875,7,0,1,0,1,2,0,2,-2,4,-1,0,2
Josh Neer,Melvin Guillard,380,1,0,1,-1,1,1,-1,2,-3,5,0,0,2
Duane Ludwig,Jonathan Goulet,-235,0,0,0,0,0,0,0,0,0,0,-1,0,2
Spencer Fisher,Aaron Riley,317,1,0,-1,1,-1,-1,1,-2,3,-5,-4,0,2
Joshua Burkman,Drew Fickett,506.75,4,0,-1,1,1,1,1,0,1,-1,1,0,2
Georges St-Pierre,Sean Sherk,550.375,2,0,1,0,1,-1,0,-1,1,-2,8,0,2
Matt Hughes,Joe Riggs,12.81982422,-23,-9,-1,0,-5,-9,-1,-8,7,-15,-9,-1,2
Diego Sanchez,Nick Diaz,1.6875,7,-1,0,0,0,2,1,1,0,1,-1,0,2
Joe Riggs,Chris Lytle,349.375,9,0,-1,2,1,1,2,-1,3,-4,8,-1,2
Drew Fickett,Josh Koscheck,-0.5,0,0,2,-1,1,1,-1,2,-3,5,2,0,2
Georges St-Pierre,Frank Trigg,-358.625,-3,1,-2,1,0,-1,1,-2,3,-5,9,1,2
Kenny Florian,Alex Karalexis,-69,0,-1,1,-1,1,1,-1,2,-3,5,-2,-1,2
Josh Koscheck,Pete Spratt,25.5,3,0,0,0,0,1,1,0,1,-1,7,0,2
Nick Diaz,Koji Oishi,395.625,-6,0,-2,1,-2,-3,0,-3,3,-6,7,-1,2
Karo Parisyan,Matt Serra,60.796875,9,0,-1,1,0,1,2,-1,3,-4,9,0,2
Matt Hughes,Frank Trigg,-152.1103516,-23,-7,-2,1,-4,-8,-1,-7,6,-13,1,-1,2
Karo Parisyan,Chris Lytle,-253.25,2,0,-1,2,1,0,1,-1,2,-3,8,0,2
Frank Trigg,Renato Verissimo,655.5,4,-1,1,-1,0,0,0,0,0,0,-1,-1,2
Matt Hughes,Georges St-Pierre,-179.7207031,-22,-7,0,0,-4,-7,-2,-5,3,-8,-8,-2,2
Karo Parisyan,Nick Diaz,-8.5,1,0,1,0,1,1,-1,2,-3,5,0,1,2
Matt Hughes,Renato Verissimo,438.5585938,-20,-7,-1,0,-5,-7,-2,-5,3,-8,0,-2,2
Frank Trigg,Dennis Hallman,526,5,0,1,-1,1,1,0,1,-1,2,-4,-1,2
Chris Lytle,Tiki Ghosn,-461.5,0,0,0,1,0,0,1,-1,2,-3,-2,0,2
Nick Diaz,Robbie Lawler,-74.1875,8,0,2,0,2,3,1,2,-1,3,2,0,2
BJ Penn,Matt Hughes,-495.2578125,4,4,-1,0,3,3,-1,4,-5,9,5,2,2
Robbie Lawler,Chris Lytle,200.375,-6,0,-3,1,-3,-3,0,-3,3,-6,8,-1,2
Pete Spratt,Robbie Lawler,226.25,4,0,2,0,2,2,-1,3,-4,7,-11,1,2
Matt Hughes,Sean Sherk,-107.78125,-10,-4,1,0,-1,-3,-1,-2,1,-3,0,-2,2
Robbie Lawler,Tiki Ghosn,-125.5,-1,0,-2,2,-2,-2,2,-4,6,-10,5,-1,2
Carlos Newton,Pete Spratt,-666,-11,-4,0,0,0,-1,-3,2,-5,7,5,0,2
Matt Hughes,Gil Castillo,284.9375,-7,-2,-2,1,-2,-4,0,-4,4,-8,8,-1,2
Sean Sherk,Benji Radach,-280,-1,0,-2,1,-1,-1,1,-2,3,-5,-6,0,2
Matt Hughes,Carlos Newton,-208.125,-3,1,-1,0,-1,-2,1,-3,4,-7,-3,-2,2
Robbie Lawler,Steve Berger,-436.5,1,0,-1,2,-1,-1,2,-3,5,-8,9,-1,2
Sean Sherk,Jutaro Nakao,-272,0,0,0,0,0,0,0,0,0,0,3,1,2
Gil Castillo,Chris Brennan,-958,-4,0,0,0,0,0,0,0,0,0,-6,-1,2
Matt Hughes,Carlos Newton,319.5,1,2,-1,0,-1,0,0,0,0,0,-3,-2,2
Pat Miletich,Shonie Carter,110.671875,-11,-7,-4,0,-4,-4,-1,-3,2,-5,-4,1,2
Carlos Newton,Pat Miletich,23.65625,12,5,6,0,6,6,-1,7,-8,15,9,0,2
Pat Miletich,Kenichi Yamamoto,146.1875,-8,-4,-4,0,-4,-4,0,-4,4,-8,-8,0,2
Fabiano Iha,Daiju Takase,310.25,-1,0,0,0,-1,-1,0,-1,1,-2,-8,1,2
Fabiano Iha,Laverne Clark,82.75,1,0,3,-2,3,3,-2,5,-7,12,-4,0,2
Pat Miletich,Mikey Burnett,-136,-2,-1,-1,0,-1,-1,0,-1,1,-2,-6,0,2
